u #,1 # |m.| Vigésima primeira letra do alphabeto português. |Adj.| Que numa série de 21 occupa o último lugar. Na escrita antiga, há u vogal e u consoante, lendo-se êste como v.
u #,2 # |adj.| Ant. O mesmo que onde. (Do fr. ou)
ua |adj.| O mesmo que uma. |f.| O mesmo que uma.
ũa |adj.| Ant. O mesmo que uma. |f.| Ant. O mesmo que uma.
uaçaçu |m.| Bras. do N. Espécie de palmeira.
uaçaı́ |m.| Bras. Espécie de palmeira.
uacapu |m.| Bras. Árvore silvestre, de madeira durı́ssima, impenetrável á serra.
uacapurana |f.| Bras. Árvore tinctória das regiões do Amazonas.
uacarauás |m.| pl. Indı́genas do Norte do Brasil.
uacari |m.| Bras. Espécie de macaco. Peixe do Norte do Brasil.
uacari-guaçau |m.| Peixe, da |fam.| dos silúridas, do Brasil.
uaçu |adj.| O mesmo que guaçu.
uacuman |m.| Bras. Espécie de palmeira. (T. tupi)
uacurau |m.| Bras. Ave nocturna, das regiões do Amazonas.
uadadá |m.| Planta tuberculosa do Norte do Brasil.
uaipi |m.| Planta tuberculosa do Norte do Brasil.
uaiumanas |m.| pl. Indı́genas do Norte do Brasil.
uaiumás |m.| pl. Indı́genas do Norte do Brasil.
uaiupés |m.| pl. Trı́bo de Índios do Amazonas, hoje civilizada, que constitue a população da villa de Ega.
uaiurus |m.| pl. Indı́genas do Norte do Brasil.
uajará |m.| Fruto silvestre do Brasil.
uajuru |m.| Bras. do N. O mesmo que guajeru.
ualua |f.| Espécie de cerveja, o mesmo que quimbombo.
uamamis |m.| pl. Tribo de Índios do Brasil, de que há representantes na villa de Alvedos.
uambé |m.| Cipó do Brasil, também conhecido por ambé, (philodendron ambe).
uamiri |m.| Bras. Pequena frexa de selvagens. (Alter. do tupi uibamirim)
uanambé |m.| Ave brasileira, do tamanho de uma pomba e de côr azul ferrete.
uananaus |m.| pl. Indı́genas do Norte do Brasil.
uanhaes |m.| pl. Povo cafreal, ao sul de Moçambique.
uanhais |m.| pl. Povo cafreal, ao sul de Moçambique.
uanhi |m.| Nome, que na África portuguesa se dá ao pygargo. Cf. Serpa Pinto, II, 85.
uaniás |m.| pl. Indı́genas do Norte do Brasil.
uapés |m.| pl. Bras. Trı́bo de Índios, nas margens do rio do mesmo nome, affluente do Rio Negro.
uapixanas |m.| pl. Indı́genas do Norte do Brasil.
uaraicus |m.| pl. Indı́genas do Norte do Brasil.
uaraná |m.| O mesmo que guaraná. Cf. Pharmacopeia Port.
uaranacuacenas |m.| pl. Bras. Trı́bo de indı́genas do Pará.
uariá |m.| Bras. Planta, de tubérculos farináceos e comestı́veis.
uariquena |f.| Bras. Espécie de pimenta vermelha.
uariquina |f.| Bras. O mesmo que uariquena.
uarubé |m.| Bras. Suco de massa de mandioca.
uaruman |m.| Bras. do N. Palmeira, o mesmo que guaruman.
uarurembóia |f.| Bras. Arbusto medicinal das regiões douassassu Amazonas.
uassassu |m.| Bras. do N. Espécie de palmeira.
uassu |adj.| O mesmo que guaçu.
uatapu |m.| Bras. do N. Buzina, com que os Índios suppõem attrahir o peixe. (Do tupi)
uatite |f.| Substância mineral, que se apresenta sob a fórma de algodão em rama, e é um hydróxydo de manganés baritı́fero, que contém óxydo de ferro e carbóne. (Do fr. ouate)
uatito |f.| Substância mineral, que se apresenta sob a fórma de algodão em rama, e é um hydróxydo de manganés baritı́fero, que contém óxydo de ferro e carbóne. (Do fr. ouate)
uaturá |m.| Bras. do N. Cesto, o mesmo que aturá.
uauaçu |m.| Bras. do N. O mesmo que coqueiro 1 .
uauçu |m.| Planta leguminosa do Brasil. O mesmo que uauaçu, provavelmente, e o mesmo que uassu.
uauı́ra |f.| Gênio das águas, entre os indı́genas do Tocantins.
uaupés |m.| pl. Bras. Trı́bo de aborı́genes do Pará, provavelmente o mesmo que Uapés.
uavaona |f.| Bras. Árvore fructı́fera dos sertões.
ubá |f.| Planta amomácea. * Bras. Canôa, de uma só peça de madeira, sem quilha e sem bojo.
ubaaçu |m.| O mesmo que pau-pereira.
ubacaba |m.| Planta myrtácea do Brasil.
ubacaia |f.| O mesmo que cana-de-macaco.
ubaia |f.| O fruto da ubaia-muchama. * O mesmo que ubaiamuchama.
ubaia-muchama |f.| Arbusto myrtáceo da América.
ubaia-muxama |f.| Arbusto myrtáceo da América.
ubaı́na |f.| Alcalóide da ubaia.
ubango |m.| Pássaro dentirostro da África.
ubarana |f.| Peixe marı́timo, ordinário, do Brasil.
ubatan |m.| Bras. Árvore terebinthácea dos sertões.
uberana |f.| O mesmo que ubarana.
uberdade |f.| Qualidade de úbere. Abundância. Fertilidade; fecundidade. Opulência; fartura. (Do lat. ubertas)
úbere |adj.| Fértil; abundante; farto. |M.| Têta, glândula mamal. (Lat. uber )
ubérrimo |adj.| Muito úbere, muito abundante. (Lat. uberrirmus)
ubertoso |adj.| Poét. O mesmo que úbere. (Cp. lat. ubertus)
ubi |m.| Bras. Gênero de palmeiras.
ubianganga |f.| Espécie de corvo africano.
ubim |m.| Bras. Gênero de palmeiras.
ubim-mirim |m.| Bras. do N. Espécie de palmeira.
ubim-uaçu |m.| Bras. do N. Espécie de palmeira, cujas fôlhas servem para cobrir casas.
ubiquação |f.| Propriedade ou estado do que é ubı́quo. (Do lat. ubique)
ubiquidade #,(qu-i )# |f.| Propriedade ou estado do que é
ubı́quo. (Do lat. ubique)
ubiquista #,(qu-is)# |m.| Membro de uma seita lutherana, segundo a qual o corpo de Christo está presente na Eucharistia, não em virtude da transubstanciação, mas porque êlle está em toda a parte. (De ubı́quo)
ubiquitário #,(qu-i )# |m.| O mesmo que ubiquista.
ubı́quo |adj.| Que está ao mesmo tempo em toda a parte. (Do lat. ubique)
ubiracicá |f.| O mesmo que icica.
ubirarema |f.| O mesmo que ibirarema.
ubre |m.| (V. úbere)
ubuçu |m.| Bras. Espécie de coqueiro.
ubussu |m.| Bras. Espécie de coqueiro.
uçá |m.| Bras. Espécie de formiga.
ucace |m.| Decreto do Imperador da Rússia. (Do russo ukás, ordenação)
ucanha |f.| Fruta de Moçambique.
ucha #,1 # |f.| (e der.) O mesmo que hucha, etc. |Loc.| pop. Ficar á ucha, ficar sem nada, ficar a chuchar no dedo.
ucha #,2 # |f.| Prov. Queimada de urze. (De uscla, por ústula, do lat. ustus)
uçu |adj.| O mesmo que guassu ou guaçu.
ucubu |m.| Árvore da ilha de San-Thomé.
ucui |m.| Planta antifebril da Guiné.
ucuuba |f.| Árvore myristicácea do Brasil, (myristica officı́nalis).
udo |m.| Coisa nenhuma: “...não deixei na matéria udo nem miúdo”. Castilho, Felic. pela Agr. (Aphérese de graúdo?)
udometria |f.| Emprêgo do udómetro.
udométrico |adj.| Relativo á udometria.
udómetro |m.| O mesmo que pluviómetro. (Do lat. udus + gr. metron)
udora |f.| Gênero de crustáceos decápodes. Espécie de alga americana. (Do gr. udor )
udótea |f.| Gênero de plantas phýceas.
uerequenas |f.| pl. Bras. Trı́bo de aborı́genes do Pará.
uerimás |m.| pl. Índios selvagens das margens do Apaporis, no Brasil.
ufa, á |loc. adv.| Abundantemente; á larga. Á custa alheia. (It. uffa)
ufá! |interj.| (designativa de admiração, ironia, cansaço) (Do fr. ouf )
ufanamente |adv.| De modo ufano; com ufania; com vanglória.
ufanar |v. t.| Tornar ufano. Regosijar; causar vaidade em.
ufania |f.| Qualidade do que é ufano. Vanglória; vaidade; ostentação.
ufano |adj.| Que se orgulha de alguma coisa; que se vanglorı́a. Jactancioso; vaidoso. Satisfeito de si próprio. Ostentoso; bizarro. (De ufa)
ufanoso |adj.| Que tem ufania; envaidado; ufano. (De ufano)
uga #,1 # |f.| O mesmo que ujamanta. Cf. Bluteau, Vocab.
uga #,3 # |f.| Gı́r. Fazer a uga, continuar. (Cp. ugalhar )
uga!,2 |interj.| Prov. trasm. Àvante! para a frente!
ugalha |f.| Pop. O mesmo que igualha: “busque-lhe da sua
ugalha o pai vaqueiro á novilha”. |F.| Manuel.
ugalhar |v. t.| Marn. O mesmo que apancar. (Corr. do igualar )
ugalho |m.| Espécie de ancinho ou varredoiro, nas salinas. (De ugalhar )
ugar #,1 # |v. t.| Gı́r. Gritar; dar alarma.
ugar #,2 # |v. t.| Prov. O mesmo que igualar. Apertar (mólhos). (Por igar = igaar, contr. de igualar )
uge |m.| Peixe, o mesmo que ujo.
ugerbo |m.| Outra fórma de ogervão. Cf. S. Costa, Hist. das Pl. Méd.
uginas |m.| pl. Indı́genas do Norte do Brasil.
ugonotos |m.| pl. (V. huguenotes). Cf. Sousa, Vida do Arceb., I, 387.
úgrico |m.| Grupo de lı́nguas uralo-altaicas. Uma dessas lı́nguas.
ugro |pref.| (designativo do úgrico)
ugro-finlandês |adj.| Diz-se de um grupo de lı́nguas uralo-2023 altaicas.
uhlano |m.| Cavalleiro, armado de lança, no exército austriaco e alemão. (Al. uhlan, do polaco ula, lança)
ui! |interj.| (designativa de surpresa, admiração, repugnância ou dôr )
uı́aás |m.| pl. Bras. Tribo de aborı́genes de Mato-Grosso.
uiacima |f.| Bras. Árvore dos sertões.
uiaeira |f.| Bras. Árvore fructı́fera dos sertões.
uiara |f.| Bras. do N. O mesmo que mãe-d’água. (T. tupi)
uigúrico |m.| Lı́ngua uralo-altaica.
uinarana |f.| Peixe do Norte do Brasil.
uiqué |m.| Fruto comestı́vel, das regiões do Amazonas, (lucuma mammosa, Gaertn.).
uirari |m.| O mesmo que curare.
uistiti |m.| Variedade de macaco.
uiti |m.| O mesmo que oiti.
uivador |m.| O que uiva. |adj.| O que uiva.
uivante |adj.| Que uiva. Cf. Dom. Vieira, vb. coruja.
uivar |v. i.| Dar uivos. Fig. Bravejar, vociferar. (Do lat. ululare?)
uivo |m.| Voz de lobo e de outras feras. Grito prolongado e lamentoso do cão. * Fig. Acto de vociferar. (De uivar )
ujamanta |f.| O mesmo ou melhór que jamanta.
ujica |f.| Bras. Espécie de quitute.
ujo |m.| Nome vulgar de uma ave de rapina, espécie de águia, também conhecida por corujão. Pequeno peixe, em fórma de raia.
ula #,1 # |f.| Prov. alg. O mesmo que fula-fula. (Contr. de fula?)
ula #,2 (Cp. ulo 1 )# 
ulano |m.| Cavaleiro, armado de lança, no exército austriaco e alemão. (Al. uhlan, do polaco ula, lança)
ulas (Cp. ulo 1 )
úlcera |f.| Ferida ou chaga antiga, cuja cicatrização é pouco provável. Alteração do tecido lenhoso das árvores. (Lat.
ulcera, pl. de ulcus, ulceris)
ulceração |f.| Acto ou effeito de ulcerar. (Do lat. ulceratio)
ulcerar |v. t.| Causar úlcera em. Fig. Atormentar; magoar. Alterar, corromper. |V. i.| e p. Adquirir úlcera; cobrir-se de úlceras. (Lat. ulcerare)
ulcerativo |adj.| Relativo a úlcera. Que ulcéra. (De ulcerar )
ulceróide |adj.| Semelhante a uma úlcera. (De úlcera + gr. eidos)
ulceroso |adj.| Que tem úlceras. Que é da natureza da úlcera. (Lat. ulcerosus)
uleda |f.| Gênero de insectos coleópteros heterómeros.
ulemás |m.| pl. Sábios ou doutores da lei, entre os Árabes e Turcos. (Ar. ulema)
ulfilano |adj.| Diz-se de uma espécie de letras góticas, cuja invenção se attribue ao Bispo Ulfilas.
ulı́dia |f.| Gênero de insectos dı́pteros.
uliginário |adj.| Bot. Que cresce em lugares húmidos. (Do lat. uligo, uliginis)
uliginoso |adj.| Lamacento; pantanoso. * Diz-se dos vegetaes que crescem em terrenos pantanosos. (Lat. uliginosus)
ulissiponense |adj.| O mesmo que olisiponense. Cf. Herculano.
ulite |f.| Inflammação da membrana mucosa das gengivas. (Do gr. oulon)
ulluco |m.| Gênero de plantas portuláceas da Bolı́via e do Peru, (ullucus tuberosus, Collas).
ulmáceas |f.| pl. Famı́lia de plantas, que tem por typo o
ultimadamente
ulmo. (Fem. pl. de ulmáceo)
ulmáceo |adj.| Relativo ou semelhante ao ulmo.
ulmarena |f.| Preparação pharmacêutica, contra o rheumatismo articular. (De ulmária)
ulmária |f.| Planta rosácea, (spiraea ulmaria, Lin.) (De ulmo)
ulmárico |adj.| Diz-se de um ácido, que é a ulmarina.
ulmarina |f.| Chı́m. Pó crystallino, que se extrái da ulmária.
ulmato |m.| Sal, resultante da combinação do ácido úlmico com uma base. (De ulmo)
ulmeira |f.| O mesmo que ulmária.
ulmeiro |m.| O mesmo que ulmo.
úlmico |adj.| Diz-se de um ácido, que existe no terriço e casca do ulmo. (De ulmo)
ulmina |f.| Um dos productos da decomposição da cellulose. (De ulmo)
ulmo |m.| (V. olmo)
ulna |f.| Nome antigo do cúbito. Espécie de medida antiga, equivalente a uma braça. (Lat. ulna)
ulnal |adj.| O mesmo que ulnário.
ulnário |adj.| Relativo ao cúbito. (De ulna)
ulo #,1 (juncção do ant. |adv.| u, onde, e do |art.| lo)# : “ulo ser a autoridade de fidalgo?” Sousa, Vida do Arceb., II, 68. E assim ulos = onde os; ula = onde a; ulas = onde as.
ulo #,2 # |m.| Bras. Grito; gemido.
ulóboro |m.| Gênero de arachnı́deos.
ulodendro |m.| Gênero de vegetaes fósseis. (Do gr. oulos + dendron)
ulofobia |f.| Mania, caracterizada por certa aversão aos próprios filhos.
ulojanja |f.| Pássaro conirostro africano.
uloncia |f.| Inchação das gengivas. (Do gr. oulon + onkos)
ulophobia |f.| Mania, caracterizada por certa aversão aos próprios filhos.
ulorragia |f.| Hemorragia nas gengivas. (Do gr. oulon + regnumi)
ulorrhagia |f.| Hemorrhagia nas gengivas. (Do gr. oulon + regnumi)
ulos (Cp. ulo 1 )
ulosomo #,(sô)# |m.| Gênero de insectos coleópteros tetrâmeros. (Do gr. oulos + soma)
ulossomo |m.| Gênero de insectos coleópteros tetrâmeros. (Do gr. oulos + soma)
ulótricho #,(co)# |adj.| Que tem cabellos crespos. Que tem crespos os appêndices ciliares. |M.| Gênero de algas filamentosas. Pl. Homens de cabello lanoso ou crespo, que constituem a primeira divisão da espécie humana, no systema de |F.| Müller. (Do gr. oulotrikhos)
ulótrico |adj.| Que tem cabelos crespos. Que tem crespos os apêndices ciliares. |M.| Gênero de algas filamentosas. Pl. Homens de cabelo lanoso ou crespo, que constituem a primeira divisão da espécie humana, no sistema de |F.| Müller. (Do gr. oulotrikhos)
ulterior |adj.| Situado além. Que está ou succede depois. Que chega depois. (Lat. ulterior )
ulterioridade |f.| Qualidade do que é ulterior.
ulteriormente |adv.| Depois. Em lugar ulterior; ultimamente. (De ulterior )
última |f.| (V. últimas)
ultimação |f.| Acto de ultimar. Aperfeiçoamento.
ultimadamente |adv.| O mesmo que ultimamente. Por úl-ultimado timo. Até o ponto extremo. (De ultimado)
ultimado |adj.| Concluı́do; acabado. (De ultimar )
ultimador |m.| Apparelho, com que se ultimam certas operações, em fábricas de tecidos. Cf. Inquér. Industr., p. II, V. III, 89 e 91.
ultimamente |adv.| Por último; posteriormente. Há pouco:
ultimamente, encontrei-o no Chiado. Nos últimos tempos, nos tempos mais próximos de agora: ultimamente, tem tido desgostos. (De último)
ultimar |v. t.| Terminar; concluı́r. (De último)
últimas |f.| pl. O ponto extremo. A extrema miséria. Lance decisivo. Hora final da vida: o doente está nas últimas. (De último)
ultimato |m.| Nome, que se deu ás últimas moléculas, a que
um corpo póde sêr reduzido. * O mesmo ou melhor que
ultimatum. (De último)
ultimatum #,(má)# |m.| Últimas condições, que um Estado apresenta a outro, e de cuja acceitação depende o não se declarar guerra. |Ext.| Resolução final e irrevogável. (T. lat.)
último |adj.| Que está ou vem depois de todos os outros:
último monarcha de uma dynastia. O mais moderno, na ordem chronológica: em Setembro último. Que é o mais recente: as últimas notı́cias da guerra. Derradeiro. Precedente. Que está no lugar menos importante. Que é o mais insignificante. Final: no último instante. Restante. Extremo: está na última miséria. Ínfimo: as últimas camadas sociaes. Gravı́ssimo. Decisivo. |M.| Aquelle ou aquillo que vem ou está depois de todos os outros. Aquelle ou aquillo que occupa a posição mais humilde ou ı́nfima. O que é piór que todos. (Lat. ultimus)
ultimogênito |m.| O filho mais novo. Cf. Rui Barb., Réplica, 158. (Do lat. ultimus + genitus)
ultor |m.| Aquelle que vinga; vingador. Cf. Rui Barb., Réplica, 158.
ultra |pref.| (designativo de além ou de excesso) (Lat. ultra)
ultraexistência |f.| Des. Qualidade de ultraexistente.
ultraexistente |adj.| Que existe àlém da morte. (De ultraexistir )
ultraexistir |v. i.| Des. Existir àlém da morte. Sobreviver ao corpo, (falando-se da alma) (De ultra... + existir )
ultrajador |m.| O que ultraja. |adj.| O que ultraja.
ultrajante |adj.| Que ultraja.
ultrajar |v. t.| Insultar, afrontar. Offender a dignidade de. Diffamar. (De ultraje)
ultraje |m.| Acto ou effeito de ultrajar. Afronta. (Do lat. hyp. ultraticum)
ultrajoso |adj.| O mesmo que ultrajante.
ultraliberal |m.| Excessivamente liberal. (De ultra... + liberal ) |adj.| Excessivamente liberal. (De ultra... + liberal )
ultraliberalismo |m.| Liberalismo exaggerado. (De ultra... + liberalismo)
ultramar |m.| Região ou regiões além do mar. Possessões
ultramarinas: os governadores do Ultramar. Tinta azul, extrahida do lápis-lazúli. (De ultra... + mar )
ultramarino |adj.| Relativo ao ultramar: questões ultramarinas. Situado no ultramar.
ultramonárchico #,(qui )# |adj.| Excessivamente monárchico. Cf. Latino, Elogios, 195 e 336. (De ultra... + monárchico)
ultramonárquico |adj.| Excessivamente monárquico. Cf. Latino, Elogios, 195 e 336. (De ultra... + monárchico)
ultramontanismo |m.| Systema dos Ultramontanos. (De ultramontano)
ultramontano |adj.| Trasmontano. Relativo aos princı́pios da côrte de Roma, quanto ao poder ecclesiástico. |M.| Aquelle que sustenta ou defende o poder absoluto do Papa, na ordem espiritual e temporal. (De ultra... + monte)
ultramundano |adj.| Excessivamente mundano. Cf. Latino, Humboldt, 522. (De ultra... + mundano)
ultraoceânico |adj.| Situado àlém do Oceano. (De ultra... + oceano)
ultraparodoxal #,(csal )# |adj.| Excessivamente parodoxal. Cf. Latino, Elogios, 62. (De ultra... + parodoxal )
ultrapassar |v. i.| Passar além de. Transpor. Exceder o limite de: ultrapassar a paciência de alguém. (De ultra... + passar )
ultrarealismo #,(re)# |m.| Systema ou opinião dos ultrarealistas. (De ultra... + realismo)
ultrarealista #,(re)# |adj.| Relativo ao ultrarealismo. |M.| Partidário do despotismo ou do poder absoluto dos monarchas. (De ultra... + realista)
ultrarrealismo |m.| Sistema ou opinião dos ultrarrealistas. (De ultra... + realismo)
ultrarrealista |adj.| Relativo ao ultrarrealismo. |M.| Partidário do despotismo ou do poder absoluto dos monarcas. (De ultra... + realista)
ultrasensı́vel #,(sen)# |adj.| Extraordinariamente sensı́vel. (De ultra... + sensı́vel )
ultrassensı́vel |adj.| Extraordinariamente sensı́vel. (De ultra... + sensı́vel )
ultrazodiacal |adj.| Diz-se dos planetas, cuja órbita não está comprehendida na largura do Zodı́aco. (De ultra... + zodiacal )
ultrice |f.| Que vinga. |F.| Mulhér vingadora, mulhér que se vinga. (Lat. ultrix )
ultriz |adj.| Poét. Que vinga. |F.| Mulhér vingadora, mulhér que se vinga. (Lat. ultrix ) |f.| Poét. Que vinga. |F.| Mulhér vingadora, mulhér que se vinga. (Lat. ultrix )
ultróneo |adj.| Des. Espontâneo. (Lat. ultroneus)
uluco |m.| Gênero de plantas portuláceas da Bolı́via e do Peru, (ullucus tuberosus, Collas).
ululação |f.| Acto ou effeito de ulular. (Do lat. ululatio)
ululador |m.| O que ulula. |adj.| O que ulula.
ululante |adj.| Que ulula; lamentoso. (Lat. ululans)
ulular |v. i.| Soltar voz triste e lamentosa. Uivar; gannir. Fig. Gritar afflictivamente. Queixar-se, gritando. |V. t.| Exprimir, gritando lamentosamente. Proferir, berrando. Bradar. |M.| Ululação. (Lat. ululare)
ululato |m.| O mesmo que ululação. Cf. Júl. Ribeiro, Padre Belch., 137.
ulva |f.| Gênero de algas, que nascem nos paues e á beira de águas estagnadas. (Lat. ulva)
ulváceas |f.| pl. Famı́lia de plantas, que tem tem por typo a ulva.
ulvina |f.| Gênero de algas, de que há quatro espécies. (Do lat. ulva)
um #,1 # |adj.| Diz-se do número cardinal, que exprime uma só
unidade: um homem. Que é o primeiro de todos os números. Uno; único. Que se distingue de todos os outros. Contı́nuo, indivisı́vel. |Art.| Qualquer. Algum; certo. * |M.| Algarismo, que representa o número um. * Prov. alg.2025 Homem sem préstimo. (Do lat. unus)
um #,2 # |m.| Árvore de Damão, (guatteria cerasoides).
uma |adj.| (Fem. de um) * |Loc. adv.| Á uma, juntamente; ao mesmo tempo. Por um lado. (Do lat. una)
umans |m.| pl. Antiga trı́bo de Índios de Pernambuco.
umar |v. i.| Prov. minh. Ganhar umidade e estragarse, (falando-se da madeira). (Colhido em Barcelos) (Cp. úmido)
umari |m.| Nome de duas plantas leguminosas do Brasil.
umauás |m.| pl. Indı́genas do Norte do Brasil.
umbala |f.| T. da África Port. O mesmo que libata.
umbamba |f.| Espécie de palmeira do Brasil.
umbaru |m.| Planta meliácea do Brasil.
umbaúba |f.| Árvore urticácea, (cecropia palmata).
umbela |f.| Guarda-sol; sombrinha. Pequeno pállio redondo. Bot. Inflorescência, formada por eixos que, partindo do mesmo ponto, chegam á mesma altura, produzindo uma superfı́cie convexa, á semelhança de um guarda-chuva, como na flôr das assembleias, (plantas). (Lat. umbella)
umbeladas |f.| pl. O mesmo que umbelı́feras.
umbelado |adj.| O mesmo que umbelı́fero. Cf. Júl. Dinis, Morgadinha, 33. (De umbela)
umbelı́feras |f.| pl. Famı́lia de plantas dicotiledóneas, cuja inflorescência toma a fórma de umbela. (Fem. pl. de umbelı́fero)
umbelı́fero |adj.| Que tem umbela. Bot. Que tem flôres dispostas em umbela. (Do lat. umbella + ferre)
umbella |f.| Guarda-sol; sombrinha. Pequeno pállio redondo. Bot. Inflorescência, formada por eixos que, partindo do mesmo ponto, chegam á mesma altura, produzindo uma superfı́cie convexa, á semelhança de um guarda-chuva, como na flôr das assembleias, (plantas). (Lat. umbella)
umbelladas |f.| pl. O mesmo que umbellı́feras.
umbellado |adj.| O mesmo que umbellı́fero. Cf. Júl. Dinis, Morgadinha, 33. (De umbella)
umbellı́feras |f.| pl. Famı́lia de plantas dicotyledóneas, cuja inflorescência toma a fórma de umbella. (Fem. pl. de umbellı́fero)
umbellı́fero |adj.| Que tem umbella. Bot. Que tem flôres dispostas em umbella. (Do lat. umbella + ferre)
umbéllula |f.| Umbella pequena.
umbellulária |f.| Animal ou grupo de animaes, que têm um caule commum e fixo, como as plantas, o qual termina superiormente numa inflorescência em capı́tulo.–É da Groenlândia. Cf. Caminhoá, Bot. Ger. e Med. (De umbéllula)
umbélula |f.| Umbela pequena.
umbelulária |f.| Animal ou grupo de animaes, que têm um caule comum e fixo, como as plantas, o qual termina superiormente numa inflorescência em capı́tulo.–É da Groenlândia. Cf. Caminhoá, Bot. Ger. e Med. (De umbélula)
umbigada |f.| Pancada com o umbigo ou com a barriga. Região do umbigo.
umbigo |m.| Anat. Cicatriz deprimida ou saliente, resultante do córte do cordão umbilical. |Ext.| Centro. (Do lat. umbilicus)
umbigo-de-freira |m.| Bras. Espécie de biscoitos doces, que se servem ao chá.
umbigo-de-vênus |m.| Bot. O mesmo que coucelo.
umbilicado |adj.| Semelhante ao umbigo. (Do lat. umbilicatus)
umbilical |adj.| Relativo ao umbigo. Diz-se do cordão, que
ume liga o féto á placenta e que, durante a gestação, lhe transmitte os sucos nutritivos. (Do lat. umbilicus)
umbla |f.| Espécie de salmão. (Do fr. umbre)
umblina |f.| Peixe esquamodermo. (De umbla)
umblo |m.| Árvore da ilha de San-Thomé.
umbraculı́feras |f.| pl. Ordem de plantas, que comprehende as umbellı́feras, as araliáceas e as cornuáceas. (Fem. pl. de umbraculı́fero)
umbraculı́fero |adj.| Hist. Nat. Que tem órgão em fórma de umbella. (Do lat. umbraculum + ferre)
umbraculiforme |adj.| Bot. Que tem fórma de umbella. (Do lat. umbraculum + forma)
umbráculo |m.| Bot. Espécie de disco, que corôa o pedúnculo de algumas plantas cryptogâmicas. (Lat. umbraculum)
umbral |m.| O mesmo ou melhor que humbral. Cf. Herculano, Cistér, 52.
umbrático |adj.| Poét. Relativo a sombra. Que se deleita com a sombra ou que a procura. Obscuro. Imaginário. (Lat. umbraticus)
umbratı́cola |adj.| Hist. Nat. Que vive ou cresce em lugares sombrios. (Do lat. umbraticus + colere)
umbrátil |adj.| Umbrático. Fantástico; allegórico. (Lat. umbratilis)
umbrela |f.| O mesmo que umbela. Gênero de moluscos gasterópodes.
umbrelado |adj.| O mesmo que umbelı́fero.
umbrella |f.| O mesmo que umbella. Gênero de molluscos gasterópodes.
umbrellado |adj.| O mesmo que umbellı́fero.
umbreta #,(brê)# |f.| Gênero de aves pernaltas.
umbria |f.| Poét. Lugar sombrio. Vertente occidental de um monte. * Prov. alent. Vertente setentrional de um monte, onde o mato cresce mais.–Os diccion. trazem a palavra como proparoxýtona; considero-a porém paroxýtona, não só porque assim o é em cast., mas principalmente porque é derivada e tem um suff. que, exprimindo qualidade, nunca é átono. (Cast. umbrı́a)
úmbrico |adj.| Relativo a Úmbria ou aos Umbros. |M.| Antigo dialecto do ramo itálico. (De Úmbria, |n. p.| )
umbrı́cola |adj.| Que vive nas sombras. (Lat. umbricola)
umbrı́fero |adj.| Sombrio, umbroso. (Lat. umbrifer )
umbrinos |m.| Pl. Gênero de peixes, semelhantes ás percas, (umbrina communis). (Do lat. umbra)
umbro |m.| Cão para caçar veados. * O dialecto úmbrico. (Do lat. umber )
umbror |m.| Conjunto de sombras ou nuvens. Cf. Camillo, Cancion. Al., 143. (Do lat. umbra)
umbros |m.| Pl. Antigo povo italiano, que habitou entre o Tibre e o Adriático. (Lat. umbri)
umbroso |adj.| Que tem ou produz sombra. Sombrio, copado; escuro. (Lat. umbrosus)
umbu #,1 # |m.| O mesmo que imbu.
umbu #,2 # |m.| Bras. do N. Grande árvore phytollácea da América. Fruto do imbuzeiro.
umbula |f.| Árvore angolense da Caconda.
umbuzada |f.| O mesmo que imbuzada.
umbuzeiro |m.| Bras. Árvore, o mesmo que umbu 2 .
ume |adj.| Diz-se de uma pedra, que é um sulphato de alumina e potassa. |M.| O mesmo que alúmen. Cp. pedra-ume. (De alume)úmero
úmero |m.| Parte do braço, comprehendida entre o cotovelounctuoso |adj.| Em que há unto ou gordura. Gorduroso. e a espádua. (Lat. humerus, ou umerus) * |m.| Fórma preferı́vel a húmero. (Lat. umerus)
úmido |adj.| (e der.) O mesmo ou melhór que húmido, etc. (Lat. umidus) |adj.| Levemente molhado; que tem a natureza da água. Aquoso; impregnando de vapores aquosos. (Lat. humidus, ou umidus)
umiri |m.| Planta meliácea do Brasil, (umirium balsamiferum). Nome de um óleo, extrahido da casca dessa árvore.
umpada |f.| Árvore angolense.
umperevu |m.| Árvore de Moçambique.
unanimar |v. t.| Tornar unânime.
unânime |adj.| Que tem o mesmo sentimento ou a mesma opinião que outrem. Relativo a todos, geral. Proveniente de acôrdo commum; concorde: por votação unânime. (Lat. unanimus)
unanimemente |adv.| De modo unânime.
unanimidade |f.| Qualidade do que é unânime. Conformidade de opinião ou de voto. (Do lat. unanimitas)
unau |m.| Mammı́fero tardı́grado, da América do Sul.
unça |adj.| T. de Alcanena. Diz-se de uma erva aromática, silvestre, de fôlhas miúdas, que se emprega na curtimenta da azeitona. |f.| T. de Alcanena. Diz-se de uma erva aromática, silvestre, de fôlhas miúdas, que se emprega na curtimenta da azeitona.
unção |f.| Acto ou effeito de ungir ou untar. Fig. Sentimento de piedade. Doçura commovente na expressão. Modo insinuante de dizer. (Do lat. unctio)
uncção |f.| Acto ou effeito de ungir ou untar. Fig. Sentimento de piedade. Doçura commovente na expressão. Modo insinuante de dizer. (Do lat. unctio)
úncia |f.| O mesmo que pollegada. Cf. Castilho, Fastos, 353 e 387. (Lat. uneia)
uncial |adj.| Dizia-se das letras ou caracteres maiúsculos, em que eram escritos os textos ecclesiásticos medievaes até o século XI.–Os minúsculos começaram a usar-so no século X, reservando-se as letras unciaes para os tı́tulos das obras e dos capı́tulos. A Escritura semi-uncial era mais pequena que a uncial ordinária. Cf. Mélida, Vocab. de Term. (Lat. uncialis)
unciário |adj.| Que tinha direito á duodécima parte de uma herança, segundo a jurisprudência romana. (Lat. unciarius)
unciforme |adj.| Que tem fórma de gancho. |M.| Anat. O quarto osso da segunda série do corpo. (Do lat. uncus + forma)
uncinado |adj.| Que tem unha. Que tem fórma de unha ou de garra. Que termina em unha. (Do lat. uncinatus)
uncı́nia |f.| Gênero do plantas cyperáceas. (Cp. uncinado)
uncirostro #,(rós)# |adj.| Que tem bico curvo, em fórma de
unha. |M.| Pl. Famı́lia de aves pernaltas, de bico adunco. (Do lat. uncus + rostrum)
uncirrostro |adj.| Que tem bico curvo, em fórma de unha. |M.| Pl. Famı́lia de aves pernaltas, de bico adunco. (Do lat.
uncus + rostrum)
unctório |m.| Compartimento ou sala, nas casa de banhos entre os Romanos, na qual os banhistas se friccionavam com perfumes, e onde êstes se guardavam. (Lat. unctorium)
unctuosamente |adv.| De modo unctuoso. Com uncção. Fig. Suavemente; mellifluamente.
unctuosidade |f.| Estado ou qualidade de unctuoso. Qualidade de gorduroso ou escorregadio.Lubrificado, escorregadio. Que dá ao tacto a impressão das substâncias gordurosas. * Relativo a iguarias, em que predominam môlhos e carnes: “dava cama e mesa unctuosa aos missionários...” Camillo, Brasileira, 237. Fig. Suave; amorável; meigo; mellı́fluo. (Lat. unctuosus)
undação |f.| Corrente de rio; inundação; enchente. (Do lat. undatio)
undai |m.| Planta angolense, (gardenia Jovis tonantis).
undalo |m.| Pássaro dentirostro africano.
undante |adj.| Que fórma ondas; ondeante. Que tem ou leva muita água. (Lat. undans)
unde |adv.| Obsol. Portanto, por consequência. (Lat. unde)
undecágono |m.| O mesmo que hendecágono.
undecêmviro |m.| Cada um dos onze magistrados athenienses, a quem cumpria conduzir ao patı́bulo os condemnados á pena última. (Do lat. undecim + vir )
undecênviro |m.| Cada um dos onze magistrados atenienses, a quem cumpria conduzir ao patı́bulo os condenados á pena
última. (Do lat. undecim + vir )
undecimanos |m.| pl. O mesmo que undecumanos.
undécimo |adj.| Que numa série de onze occupa o último lugar. |M.| A undécima parte. (Lat. undecimus)
undecumanos |m.| pl. Soldados da 11.ª legião, entre os antigos Romanos. (Lat. undecumani)
undécuplo |adj.| Diz-se de uma quantidade, que é onze vezes maiór que outra com que se compara. |M.| Quantidade, onze vezes maiór que outra. (Lat. hyp. undecuplus)
undeira |f.| Árvore da Índia Portuguesa, o mesmo que ponaca.
undevicesimano |m.| Soldado da 19.ª legião, entre os Romanos antigos. (Lat. undevicesimanus)
undevicésimo |adj.| O mesmo que décimonono. (Lat. undevicesimus)
undı́cola |m.| , |f.| P. us. Que vive nas águas. (Lat. |adj.| P. us. Que vive nas águas. (Lat. undicola)
undı́fero |adj.| Que tem ondas. Que contém águas. Cf. Filinto, X, 7. (Do lat. unda + ferre)
undiflavo |adj.| Poét. Que tem ondas côr de oiro ou reflexos áureos. (Do lat. unda + flavus)
undı́fluo |adj.| Que corre em ondas. Cf. Filinto, XVI, 168. (Lat. undifluus)
undı́sono #,(so)# |adj.| Poét. Que sôa como as ondas agitadas. (Lat. undisonus)
undı́ssono |adj.| Poét. Que sôa como as ondas agitadas. (Lat. undisonus)
undı́vago |adj.| Poét. Que anda sôbre as ondas. (Lat. undivagus)
undo |m.| Grande peixe africano. Cf. Serpa Pinto, I, 299.
undoso |adj.| Em que há ondas; que fórma ondas; ondeante. (Lat. undosus)
undular |v. i.| O mesmo que ondular : “mocinho entretanto, de coma a undular...” Castilho, Lir. de Anacr., 37.
undulosamente |adv.| De modo unduloso; á maneira de ondas.
unduloso |adj.| O mesmo que ondeante. (De undular )
únea-golina |f.| Árvore da ilha de San-Thomé.
ungã |m.| Tambor de honra, usado no Daomé.
ungan |m.| Tambor de honra, usado no Daomé.
ungido |adj.| Untado. |M.| Aquelle que se ungiu. (De ungir )
ungir |v. t.| Untar com substância oleosa. Friccionar com2027
uma substância gorda. Applicar óleos consagrados a. Sagrar; purificar. Fig. Influir em, com palavras insinuantes ou affectivas. (Lat. ungere)
unguari |m.| Espécie de perdiz africana.
ungueal |adj.| Relativo á unha. (Do lat. unguis)
unguebe |m.| Árvore angolense de Caconda.
unguentáceo #,(gu-en)# |adj.| Relativo ou semelhante a unguento.
unguentário #,(gu-en)# |adj.| O mesmo que unguentáceo. * |M.| Ant. O mesmo que perfumista. * Vaso para unguentos. Cf. Archeol. Port., XIV, 57. (Lat. unguentarius)
unguento #,(gu-en)# |m.| Medicamento para uso externo, pouco conistente, e que tem por base uma substância gorda. Designação antiga de certas drogas ou essências, com que se perfumava o corpo. (Lat. unguentum)
ungui #,(gu-i )# |m.| Bras. Iguaria de farinha de pau, feijões, etc.
unguiculado #,(gu-i )# |adj.| Bot. Que termina em fórma de
unha #,(falando-se das pétalas)# . Zool. Diz-se dos mammı́feros, que têm unhas. (Do lat. unguicula)
unguı́fero #,(gu-i )# |adj.| Que tem unha. (Lat. unguifer )
unguiforme #,(gu-i )# |adj.| Que tem fórma de unha. (Do lat. unguis + forma)
unguinoso #,(gu-i )# |adj.| Gordurento, oleoso. (Lat. unguinosus)
únguis |m.| Pequeno osso, semelhante a unha e situado na parte anterò-interior da órbita ocular. (Lat. unguis)
úngula |f.| Saliência membranosa do ângulo interno do ôlho. (Lat. ungula)
ungulado |adj.| Diz-se dos animaes, que têm unhas. (Do lat. ungulatus)
unha |f.| Lâmina córnea, um pouco transparente em geral, que reveste a extremidade dorsal dos dedos. Garra. Casco dos pachydermes e ruminantes. Extremidade curva do pé dos insectos. Nome de diversos opérculos das conchas. Úngula. Callosidade no dorso das bêstas; pisadura, produzida nas cavalgaduras pelos arreios. Pé do caranguejo. Pedaço de cepa ou do tronco da videira, que vai prêso ao pé do bacêllo que se cortou. Parte recurva ou ponteaguda de alguns instrumentos ou de outros objectos. * |Loc. adv.| Por
uma unha negra, por um triz. * Unha com carne, pessôa, que é da maior intimidade de outra. Têr na unha, estar na posse de, têr em seu poder. Enterrar a unha, vender muito caro. Dar á unha, trabalhar afincadamente, com muito cuidado. Unha ou unhas de fome |m.| pessôa muito avarenta. Unha do martelo, a parte opposta á cabeça do martelo; dente do martelo; orelha do martello. |Loc. interj.| Á unha! (para estimular, nas praças de toiros, os moços de forcado a fazerem pégas, ou para incitar a vias de facto indivı́duos que estão altercando) Pl. |Fam.| A mão; domı́nio, poder. |Loc. adv.| A unhas de cavallo, a toda a pressa. Untar as unhas de, peitar, subornar. Têr |f.| pessôa muito avarenta. Unha do martelo, a parte opposta á cabeça do martelo; dente do martelo; orelha do martello. |Loc. interj.| Á unha! (para estimular, nas praças de toiros, os moços de forcado a fazerem pégas, ou para incitar a vias de facto indivı́duos que estão altercando) Pl. |Fam.| A mão; domı́nio, poder. |Loc. adv.| A unhas de cavallo, a toda a pressa. Untar as unhas de, peitar, subornar. Têr
unhas na palma da mão, têr o hábito de furtar. (Do lat. ungula)
unha-de-anta |f.| Bras. O mesmo que unha-de-vaca.
unha-de-asno |f.| Nome de várias plantas medicinaes.
unha-de-boi |f.| Bras. Nome de várias plantas medicinaes.
unha-de-cavallo |f.| Um dos nomes vulgares da tussilagem.
unha-de-gato |f.| Arbusto espinhoso do Zaire, também conhecido em Piauı́, (Brasil). Bras. O mesmo que ancinho.
unha-de-vaca |f.| Bras. Planta cesalpı́nea, medicinal.
unicelular
unha-de-velha |f.| Bras. Espécie de concha longa e descòrada.
unhaca |m.| Burl. Pessôa sovina, somı́tica. Pessôa ı́ntima, muito amiga. (De unha) |f.| Burl. Pessôa sovina, somı́tica. Pessôa ı́ntima, muito amiga. (De unha)
unhada |f.| Traço, arranhadura ou ferimento feito com unha.
unhador |m.| O que unha bacellos. (De unhar ) |adj.| O que unha bacellos. (De unhar )
unhagata |f.| Planta, o mesmo que resta-boi.
unhame |m.| Des. O mesmo que inhame. Cf. B. Pereira, Prosódia, vb. cyamus.
unhamento |m.| Acto ou effeito de unhar. A parte unhada do bacêllo.
unhante |m.| Veado novo. Pescador que, na ria de Aveiro, apanha enguias á mão. Gı́r. Pessôa que rouba, que deita a unha ao que não é seu. (De unhar )
unhão #,1 # |m.| Náut. Acto ou effeito de entrançar um cabo partido, ligando com fio novo as partes separadas. Nó, com que se peiam os chicotes de um cabo, que quebrou accidentalmente. (De unha)
unhão #,2 # |m.| Variedade de maçan. (De Unhão, |n. p.| )
unhar |v. t.| Riscar ou ferir com as unhas. Arranhar. Aferrar (âncoras). Collocar na manta (o bacêllo), aconchegando-o com terra no lugar onde há de lançar raı́zes. * |V. i.| Prov. minh. Diz-se da pedra, que assenta no chão, por fórma que é diffı́cil submeter-lhe o alvião, para a erguer. (De unha)
unhas |m.| Fam. Indivı́duo somı́tico, sovina.
unhas-de-fome |m.| O mesmo que unhas. Cf. Castilho, II, 348.
unheira |f.| Bras. do S. Matadura incurável, ao lado do fio do lombo dos cavallos e proveniente do mau uso dos lombilhos.
unheiro |m.| Tumor ou inflammação, entre a unha e o dedo. (De unha)
unheirudo |adj.| Bras. do S. Que soffre unheira.
unheta #,(nhê)# |f.| Nome de várias peças para tornear metaes.
unho |m.| Acto de unhar (bacêllo).
uni |pref.| (designativo do um) (Do lat. unus)
unialado |adj.| Que tem só uma asa. (De uni... + alado)
uniangular |adj.| Que tem só um ângulo. (De uni... + angular )
união |f.| Acto ou effeito de unir. Juncção de duas coisas ou pessôas. Juncção, adhesão, contacto. Alliança; casamento. Cóito de animais. Concórdia; pacto. Confederação. Conjunto de differentes Estados que, gozando certa autonomia administrativa, estão sobordinados todos a uma administração ou govêrno central. Esfôrço moral ou intellectual com que os mýsticos procuram unir-se á ideia ou objecto que lhes occupa a mente. Traço de união, o mesmo que hýphen. (Do lat. unio)
uniarticulado |adj.| Zool. Que tem só uma articulação. (De
uni + articulado)
uniaxial #,(csi )# |adj.| Que tem um só eixo. (Do lat. unus + axis)
unicamente |adv.| De modo único; simplesmente; somente.
unicapsular |adj.| Bot. Que tem só uma cápsula. (De uni... + capsular )
unicaule |adj.| Bot. Que tem só um caule. (De uni... + caule)
unicellular |adj.| Bot. Que tem uma só céllula, ou que é formado de uma só céllula. (De uni... + cellular )
unicelular |adj.| Bot. Que tem uma só célula, ou que éunichroı́smo formado de uma só célula. (De uni... + celular )
unichroı́smo |m.| Propriedade, que alguns mineraes têm, de apresentar sempre a mesma côr, seja qual fôr a direcção dos raios luminosos que nelles incidem. (De uni... + gr. khroa)
unichroı́sta |adj.| Que tem a propriedade do unichroı́smo. (De uni... + gr. khroa)
unicidade |f.| Neol. Estado ou qualidade daquillo que é único.
unicismo |m.| Doutrina médica, de que os accidentes syphilı́ticos são determinados por um vı́rus único. (De único)
unicista |m.| , |f.| Pessôa, que segue o unicismo. (De |adj.| Pessôa, que segue o unicismo. (De único)
único |adj.| Que é só um. De cuja qualidade ou natureza não há outro. Exclusivo; excepcional. A que nada se póde comparar. Que não tem semelhante. Superior a todos os demais. (Lat. unicus)
unicolor |adj.| Que tem só uma côr. (De uni... + color )
unicorne |adj.| Que tem só uma ponta ou corno. |M.| Unicórnio. (Lat. unicornis)
unicórneo |m.| Que tem só um corno ou ponta. |M.| Espécie de rhinoceronte. (De unicorne) |adj.| Que tem só um corno ou ponta. |M.| Espécie de rhinoceronte. (De unicorne)
unicórnio |adj.| Que tem só um corno ou ponta. |M.| Espécie de rhinoceronte. (De unicorne)
unicroı́smo |m.| Propriedade, que alguns mineraes têm, de apresentar sempre a mesma côr, seja qual fôr a direcção dos raios luminosos que neles incidem. (De uni... + gr. khroa)
unicroı́sta |adj.| Que tem a propriedade do unicroı́smo. (De
uni + gr. khroa)
unicúspide |adj.| Que tem só uma ponta. (De uni... + cúspide)
unidade |f.| Quantidade, tomada arbitrariamente, para servir de termo de comparação a quantidades da mesma espécie. Princı́pio da numeração. O número um. Número inteiro, inferior a déz. Número inferior de uma série. Qualidade do que é único ou uno, ou do que não é partı́vel. Reunião de seres individuaes, considerados nas suas relações recı́procas ou caracteres communs. União. Mónada, na philosophia do Leibnitz. Coordenação das partes de um trabalho literário ou artı́stico. Acção collectiva, tendente a
um fim único. Uniformidade. Eccles. Profissão da mesma fé e obediência aos mesmos chefes. Unidade táctica, corpo de soldados, destinados a manobrar juntos, nas circunstâncias em que outros corpos manobram também juntamente: como o batalhão é a unidade táctica da infantaria... (Do lat. unitas)
unidamente |adv.| Com união; estreitamente. (De unido)
unido |adj.| Que se uniu. Que está em contacto. Junto. Ligado. (De unir )
unificação |f.| Acto ou effeito de unificar.
unificar |v. t.| Reunir num só corpo ou num todo. Tornar
uno. (Do lat. unus + facere)
unifloro |adj.| Que tem só uma flôr. (Do lat. unus + flos, floris)
unifoliado |adj.| Que tem só uma fôlha. (De uni... + foliado)
unifólio |adj.| O mesmo que unifoliado. (Do lat. unus + folium)
uniformador |adj.| Que uniforma. Cf. Herculano, Opúsc., IV, 200.
uniformar |v. t.| e p. O mesmo que uniformizar.
uniforme |adj.| Que tem só uma fórma. Que não tem variedade. Semelhante. Cujas partes são semelhantes ou idênticas; idêntico. |M.| Farda ou vestuário, feito segundo
um modelo commum, para uma corporação ou uma classe. (Lat. uniformis)
uniformemente |adv.| De modo uniforme. Da mesma maneira. Unanimemente; sem divergência. Com igualdade.
uniformidade |f.| Qualidade do que é uniforme. Monotonia. Coherência. (Do lat. uniformitas)
uniformização |f.| Acto ou effeito de uniformizar.
uniformizar |v. t.| Tornar uniforme. Fazer vestir de uniforme. |V. p.| Trajar uniforme.
unigamia |f.| Estado de unı́gamo.
unı́gamo |m.| O mesmo que monógamo. (Do lat. unus + gr. gamos)
unigênito |adj.| Único que foi gerado por seus pais. |M.| Filho
único. Christo. (Lat. unigenitus)
unijugado |adj.| Que fórma só um par. (Do lat. unus + jugum)
unilabiado |adj.| Bot. Que tem só um lábio ou lóbulo principal, (falando-se de corollas). (De uni... + labiado)
unilateral |adj.| Situado de um só lado. Que se inclina para
um lado só. Jur. Diz-se do contrato, em que só uma das partes se obriga para com outra, sem que esta contraia obrigação alguma para com aquella. (De uni... + lateral )
unilingue |adj.| Que está escrito numa só lı́ngua. (Do lat.
unus + lingua)
unilobado |adj.| Que tém só um lóbulo. (De uni... + lobulado)
unilobulado |adj.| Que tem só um lóbulo. (De uni... + lobulado)
unilocular |adj.| Hist. Nat. Que tem só uma cavidade, ou cuja cavidade não tem separações interiores. (De uni... + locular )
unı́loquo |adj.| Que exprime o sentir ou a vontade de uma pessôa só. (Do lat. unus + loqui)
unimetalismo |m.| Sistema de um só metal, para moéda. (Do lat. unus + metallum)
unimetalista |m.| Partidário do unimetalismo. |adj.| Partidário do unimetalismo.
unimetallismo |m.| Systema de um só metal, para moéda. (Do lat. unus + metallum)
unimetallista |m.| Partidário do unimetallismo. |adj.| Partidário do unimetallismo.
uninervado |adj.| Bot. Que tem só uma nervura, sem ramificações, como as fôlhas do teixo, do pinheiro, etc. (De
uni + nervo)
uninominal |adj.| Relativo a um nome só: votação uninominal. Que encerra um só nome: lista uninominal. (Do lat.
unus + nomen)
uniôa |f.| Mollusco acéphalo.
unioculado |adj.| Que tem só um ôlho. (De uni... + oculado)
unionista |m.| , |f.| Pessôa, que faz parte de uma união polı́tica. Partidário de uma confederação. (Do lat. unio, |adj.| Pessôa, que faz parte de uma união polı́tica. Partidário de uma confederação. (Do lat. unio, unionis)
unı́paro |adj.| Diz-se das fêmeas, que só parem um filho de cada vez. (Do lat. unus + p[-a]rere)
unipedal |adj.| Que tem só um pé. Relativo a um só pé. (De
uni + pedal )
unipessoal |adj.| Relativo a uma só pessôa. Que consta de
uma só pessôa. |Gram.| O mesmo que impessoal, (falandose dos verbos). (De uni... + pessoal )2029
unipessoalmente |adv.| De modo unipessoal.
unipètalado |adj.| O mesmo que unipétalo.
unipétalo |adj.| Que tem só uma pétala. (De uni... + pétala)
unipolar |adj.| Que tem só um pólo. Phýs. Diz-se dos fios de
uma pilha, que conduzem só uma electricidade. (De uni... + polar )
unipolaridade |f.| Estado de um corpo unipolar. (De uni... + polaridade)
unir |v. t.| Unificar. Juntar num só. Juntar. Aproximar. Ligar. Aggregar. Reunir. Estabelecer communicação entre. Combinar. Aconchegar. Possuir conjuntamente. Ligar pelo amor ou pelo casamento. Conciliar, estabelecer acôrdo entre. |V. i.| Adherir, ligar-se. (Lat. unire)
unirefringente #,(re)# |adj.| Phýs. Diz-se dos corpos ou substâncias, em que a luz, refractando-se, produz uma só imagem, como no vidro. (De uni... + refringente)
unireme #,(rê)# |adj.| Que tem um só remo. Cf. Castilho, Fastos, II, 413. (Do lat. unus + remus)
unirrefringente |adj.| Phýs. Diz-se dos corpos ou substâncias, em que a luz, refractando-se, produz uma só imagem, como no vidro. (De uni... + refringente)
unirreme |adj.| Que tem um só remo. Cf. Castilho, Fastos, II, 413. (Do lat. unus + remus)
unisexuado #,(se)# , (csu) |adj.| Que tem só um sexo. Bot. Que tem só estames ou só pistillos. (De uni... + sexual )
unisexual #,(se)# , (csu) |adj.| Que tem só um sexo. Bot. Que tem só estames ou só pistillos. (De uni... + sexual )
unisonamente #,(so)# |adv.| De modo unı́sono.
unisonância #,(so)# |f.| Qualidade do que é unı́sono. Conjunto de sons unı́sonos. Melodia. Monotonia. (De unisonante)
unisonante #,(so)# |adj.| Unı́sono. Que se póde executar
unı́sono. (De uni... + sonante)
unisonantemente #,(so)# |adv.| De modo unisonante.
unı́sono #,(so)# |adj.| Diz-se do acorde de vozes ou instrumentos, que faz ouvir um som único ou semelhante. Que tem som igual ao de outro. Semelhante no som. Concorde. |M.| Conjunto de sons, cuja entonação é absolutamente a mesma. (Lat. unisonus)
unissexuado #,(csu)# |adj.| Que tem só um sexo. Bot. Que tem só estames ou só pistillos. (De uni... + sexual )
unissexual #,(csu)# |adj.| Que tem só um sexo. Bot. Que tem só estames ou só pistillos. (De uni... + sexual )
unissonamente |adv.| De modo unı́ssono.
unissonância |f.| Qualidade do que é unı́ssono. Conjunto de sons unı́ssonos. Melodia. Monotonia. (De unissonante)
unissonante |adj.| Unı́ssono. Que se póde executar unı́ssono. (De uni... + sonante)
unissonantemente |adv.| De modo unissonante.
unı́ssono |adj.| Diz-se do acorde de vozes ou instrumentos, que faz ouvir um som único ou semelhante. Que tem som igual ao de outro. Semelhante no som. Concorde. |M.| Conjunto de sons, cuja entonação é absolutamente a mesma. (Lat. unisonus)
unitário |adj.| Relativo á unidade. Relativo á unidade polı́tica de um paı́s. Que tem o carácter de unidade. Que se não subdivide em zoonitos, (falando-se de animaes). |M.| Sectário de um systema theológico, em que domina a unidade. (Do lat. unitas)
unitarismo |m.| Systema unitário. (De unitário)
unitarista |m.| Partidário do unitarismo. |adj.| Partidário do unitarismo.
unteiro
unitivo |adj.| Próprio para unir ou para se unir. (Lat. unitivus)
univalve |adj.| Hist. Nat. Que se abre de um só lado, (falando-se de frutos). Formado de uma só peça, (falandose das conchas ou molluscos). (De uni... + valva)
univalvular |adj.| Bot. Que tem uma só válvula, como os follı́culos. (De uni... + válvula)
universal |adj.| Que abrange tudo, ou que se estende a tudo ou por toda a parte. Que provém de todos. Que tem o carácter de generalidade abstracta. Que tem capacidade ou aptidão para tudo. |M.| Aquillo que é universal. (Lat. universalis)
universalidade |f.| Qualidade do que é universal; totalidade. (Do lat. universalitas)
universalismo |m.| Tendência ou esfôrço para universalizar
uma ideia ou uma obra. Cosmopolitismo. Opinião dos que não reconhecem maiór autoridade que o assentimento
universal. (De universal )
universalista |adj.| Que se dedica a universalizar uma ideia ou uma obra. (Cp. universalismo)
universalização |f.| Acto ou effeito de universalizar.
universalizar |v. t.| Tornar universal; generalizar.
universalmente |adv.| De modo universal. Em toda a parte; em todo o mundo.
universidade |f.| O mesmo que universalidade: “...a universidade de todas as cousas.” Luz e Calor. Conjunto de escolas, em que se professam sciências. Estabelecimento escolar de Coimbra, em que se ensina a Theologia, o Direito, a Mathemática, a Philosophia e a Medicina. Edifı́cio, em que se professam estas faculdades. Corporação docente dessas escolas. Em França, toda a corporação docente do paı́s, escolhida pelo Estado e dirigida pelo Ministro da Instrucção Pública. (Do lat. universitas)
universitário |adj.| Relativo á universidade. Universal. |M.| Professor de uma universidade. (Do lat. universitas)
universo |adj.| O mesmo que universal. |M.| Conjunto de todos os corpos ou astros, disseminados pelo espaço illimitado. O systema solar. O mundo. A Terra. A maior parte da Terra. Os habitantes da Terra. A Sociedade. Fig. Um todo. Domı́nio moral ou material, em relação ao universo. (Lat. universus)
univocação |f.| Qualidade do que é unı́voco. (Do lat. univocatio)
univocamente |adv.| De modo unı́voco. Com causa unı́voca.
unı́voco |adj.| Que se applica a muitas coisas do mesmo gênero e da mesma ou differente espécie. Que só se póde interpretar de uma fórma. Que tem a mesma natureza. Que tem o mesmo som. Homónymo. (Lat. univocus)
uno |adj.| Um; singular; único no seu gênero ou espécie: Deus é uno. (Lat. unus)
unóculo |m.| O que tem só um ôlho. (Lat. unoculus) |adj.| O que tem só um ôlho. (Lat. unoculus)
unógatos |m.| pl. Zool. Sétima classe de insectos, no systema de Fabrı́cio.
únsia |f.| Árvore angolense de Caconda.
untadela |f.| O mesmo que untura.
untador |m.| O que unta. |adj.| O que unta.
untadura |f.| O mesmo que untura.
untar |v. t.| Applicar unto a. Esfregar com unto. Cobrir de
unto; besuntar. (De unto)
unteiro |m.| T. da Bairrada. Vaso, que usam os carreirosunto e em que elles trazem um preparado, com que untam os eixos dos carros. (De unto)
unto |m.| Gordura ou banha de porco; gordura. Óleo. * Pl. |Loc. adv.| Ir aos untos, bater, dar pancadas. Cf. G. Braga, Mal da Delfina, 4. (Lat. unctus)
untre |prep.| Ant. O mesmo que entre. Cf. S. R. Viterbo, Elucidário.
untué-de-obó |m.| Grande árvore santhomense, própria para construcções.
untuém |m.| O mesmo que untué-de-obó. Planta sapotácea, que produz um látex, semelhante á guta-percha.
untuosamente |adv.| De modo untuoso. Com uncção. Fig. Suavemente; melifluamente.
untuosidade |f.| Estado ou qualidade de untuoso. Qualidade de gorduroso ou escorregadio.
untuoso |adj.| Em que há unto ou gordura. Gorduroso. Lubrificado, escorregadio. Que dá ao tacto a impressão das substâncias gordurosas. * Relativo a iguarias, em que predominam môlhos e carnes: “dava cama e mesa untuosa aos missionários...” Camillo, Brasileira, 237. Fig. Suave; amorável; meigo; melı́fluo. (Lat. unctuosus)
untura |f.| Acto ou effeito de untar. Unto. Unguento. Substância medicinal, para fomentações. Fig. Ligeiras noções, conhecimento superficial. (Lat. unctura)
upa |f.| Salto brusco do cavallo; corcôvo. |Interj.| (própria para incitar um animal a levantar-se ou a subir). * |Ext.| Exprime o acto de se levantar alguém com difficuldade ou de erguer nos braços uma criança. (Do ingl. up)
upanda #,1 # |f.| Nome, com que os sertanejos de Angola designam qualquer demanda ou pendência. Cf. Capello e Ivens, I, 173.
upanda #,2 # |m.| Medida africana, correspondente a 2 jardas. Cf. Capello e Ivens, I, 6.
upar |v. i.| Bras. Diz-se da bêsta, que dá upas, ou pequenos saltos, erguendo as ancas.
upas |m.| Substância venenosa, com que os habitantes das ilhas de Sonda ervam as suas frechas. (Do jav. upas)
upas-tienté |m.| Planta loganiácea medicinal do Brasil.
upiúba |f.| Bras. Árvore das regiões do Amazonas, própria para construcções.
uplot |m.| Ant. O mesmo que pucho. (T. do Guzerate)
upo |m.| Espécie de beleguim na China. Cf. Peregrinação, LXXXIX.
úpsilo |m.| O mesmo ou melhór que úpsilon.
upsilóide |f.| Anat. Sutura do crânio, em fórma de Y. (Do gr. úpsilon + eidos)
úpsilon |m.| Nome da letra grega, que uns representam por
u e outros por i ou y. Designação da letra y.
uptioto |m.| Gênero de arachnı́deos.
uqueté |m.| Gênero de arbustos medicinaes da ilha de SanThomé.
uqueté-de-água |m.| Espécie de planta medicinal da ilha de San-Thomé.
uqueté-de-obó |m.| Espécie de árvore medicinal da ilha do San-Thomé.
ura |f.| Bras. do N. Larva, que se cria nas feridas dos animaes. (T. tupi)
uraca |f.| Vinho de cachos de palmeira.
úracho #,(co)# |m.| Anat. Cordão, que vai da bexiga ao umbigo do féto. (Do gr. ourakhos)
úraco |m.| Anat. Cordão, que vai da bexiga ao umbigo do féto. (Do gr. ourakhos)
uraconisa |f.| Miner. Peróxydo de urânio.
uracrasia |f.| Med. Incontinência de urinas. (Do gr. oura + krasis)
uracupa |f.| Bras. O mesmo que aracupa.
urago |m.| Commandante da última linha, no antigo exército grego. (Do gr. ouragos)
uraliano |adj.| Relativo aos montes Urales ou aos seus habitadores.
uralite |f.| Novo material de construcção, formado de cimento e amianto, próprio para proteger paredes e tectos, contra o calor e a humidade.
uralo |pref.| (designativo da região dos montes Urales)
uralo-altaico |adj.| Relativo aos Urales e ao Altai. Diz-se especialmente das lı́nguas relativas aos povos que demoram entre os Urales e o Altai.
uranar |v. t.| Misturar ou combinar com urânio.
uranato |m.| Sal, resultante da combinação do óxydo urânico com uma base. (De urânio)
urânia |f.| Formoso lepidóptero nocturno de Madagáscar e das costas da Índia. Planeta telescópico, descoberto em 1854. Planta ornamental do Brasil. Cf. Jorn.-do-Comm., do Rio, de 29-V-902.
urânico |adj.| Diz-se do óxydo e dos saes, produzidos pelo urânio.
urânio |m.| Corpo simples e metállico. (De Úrano, |n. p.| )
uranismo |m.| Inversão sexual. Homosexualidade, perversão que arrasta o indivı́duo para outro do mesmo sexo.
uranista |m.| Pessôa, que tem a perversão do uranismo. |f.| Pessôa, que tem a perversão do uranismo.
uranita |f.| Phosphato de urânio e de cal.
uranite |f.| Fosfato de urânio e de cal.
uranito |m.| O mesmo ou melhór que uranita.
úrano |m.| Nome do planeta mais distante de nós. (Gr. ouranos)
uranocro |m.| Óxydo de urânio.
uranognosia |f.| O mesmo que Astronomia. (Do gr. ouranos + gnosis)
uranognóstico |adj.| Relativo á Uranognosia.
uranografia |f.| Descripção do céu. (De uranógrafo)
uranográfico |adj.| Relativo á Uranografia.
uranógrafo |m.| Aquele que é versado em Uranografia. Astrónomo. (Do gr. ouranos + graphein)
uranographia |f.| Descripção do céu. (De uranógrapho)
uranográphico |adj.| Relativo á Uranographia.
uranógrapho |m.| Aquelle que é versado em Uranographia. Astrónomo. (Do gr. ouranos + graphein)
uranólitho |m.| O mesmo que aerólitho. (Do gr. ouranos + lithos)
uranólito |m.| O mesmo que aerólito. (Do gr. ouranos + lithos)
uranologia |f.| (e der.) O mesmo que Uranographia, etc. Estudo do estado dos céus, nas diversas épocas da idade da Terra.
uranológico |adj.| Relativo á Uranologia.
uranometria |f.| Applicação do uranómetro.
uranométrico |adj.| Relativo á uranometria.
uranómetro |m.| Instrumento, com que se medem as distâncias celestes. (Do gr. ouranos + metron)
uranoplastia |f.| Med. Restauração do véu palatino. (Do gr. ouranos + plassein)
uranorama |m.| Vista do céu, ou exposição do systema pla-2031 netário, por meio de um globo móvel. (Do gr. ouranos + horama)
uranoscopia |f.| O mesmo que Astrologia. (Do gr. ouranos + skopein)
uranoso |adj.| Miner. Diz-se do primeiro óxydo e dos saes de urânio.
uranosteoplastia |f.| O mesmo que uranoplastia. (Do gr. ouranos + osteon + plassein)
urantera |f.| Gênero de plantas melastomáceas. (Do gr. oura + antheros)
uranthera |f.| Gênero de plantas melastomáceas. (Do gr. oura + antheros)
urao |m.| Espécie de soda natural de algumas minas do México e de Venezuela.
uraptérice |m.| Gênero de insectos lepidópteros nocturnos.
uraptéryce |m.| Gênero de insectos lepidópteros nocturnos.
urapuru |m.| Pássaro canoro do Brasil.
uraquitan |m.| Bras. Variedade de pedra verde, brilhante e estimada.
urária |f.| Gênero de plantas leguminosas.
uraricus |m.| pl. Indı́genas do norte do Brasil.
urato |m.| Sal, resultante da combinação ácido úrico com
uma base. (Do rad. de urina)
uraúna |f.| Ave do Brasil.
urbanamente |adv.| De modo urbano; com delicadeza; com polidez.
urbaniciano |adj.| Dizia-se do soldado, que fazia parte da guarnição do Roma, depois do tempo de Augusto. (Lat. urbanicianus)
urbanidade |f.| Qualidade do que é urbano. Civilidade. Cortesia; affabilidade. (Do lat. urbanitas)
urbanita |m.| , |f.| Pessôa, que reside numa cidade. (De |adj.| Pessôa, que reside numa cidade. (De urbano)
urbanizar |v. t.| Tornar urbano. |Ext.| Civilizar.
urbano |adj.| Relativo á cidade: a população urbana. Fig. Affável; cortês; civilizado. * Diz-se dos prédios, próprios para habitação, em opposição a prédios rústicos ou prédios para cultivar. |M.| Bras. Guarda urbano, polı́cia civil. (Lat. urbanus)
urbeque |m.| Insecto parasito das árvores fructı́feras, que lhes ataca os gomos, (rhynchites betuleti). Cf. P. Moraes, Zool. Elem., 732.
urca #,1 # |f.| Antiga embarcação portuguesa, muito larga. Pop. Mulhér gorda e feia. |Adj.| Bras. Grande, enorme. (Cp. urco)
urca #,2 # |f.| Prov. beir. Pequeno pássaro do campo. (Colhido em Sátão)
urcela |f.| T. da Bairrada. Cada uma das peças de madeira, que se erguem sôbre um dos lados do lagar de vinho e entre as quaes há uma travessa que serve de eixo á vara do lagar.
urcéola |f.| O mesmo que urcéolo.
urceolado |adj.| Bot. Diz-se de um órgão vegetal, bojudo na parte média, apertado no orifı́cio e dilatado no limbo. (De urcéolo)
urceolar |adj.| O mesmo que urceolado.
urceolı́fero |adj.| Bot. Que tem urcéolos. (Do lat. urceolus + ferre)
urcéolo |m.| Órgão vegetal, em fórma de copo ou tigelinha. (Lat. urceolus)
urchila |f.| Substância vegetal, roxa, usada em Pintura. (Cast. urchilla)
ureterolı́tico
urchilla |f.| Substância vegetal, roxa, usada em Pintura. (Cast. urchilla)
urco |m.| Cavallo forte e corpulento, também conhecido por frisão. * |Adj.| Bras. do N. Grande; formidável.
urdição |f.| O mesmo que urdidura. Cf. Inquér. Industr., p. II, V. III, 75.
urdideira |f.| Diz-se da mulhér que urde ou tece. * |F.| Conjunto de duas peças parallelas e verticaes, guarnecidas de pregos de madeira, em que se urdem os ramos da teia.– Na Beira-Baixa, em vez de pregos de madeira, também se |adj.| Diz-se da mulhér que urde ou tece. * |F.| Conjunto de duas peças parallelas e verticaes, guarnecidas de pregos de madeira, em que se urdem os ramos da teia.– Na Beira-Baixa, em vez de pregos de madeira, também se
usam ganchos de ferro, cravados em parede. (De urdir )
urdidor |m.| O que urde. * |M.| Caixa baixa, com casas em que estão os novelos, donde se tiram os fios que formam o ramo da teia. |adj.| O que urde. * |M.| Caixa baixa, com casas em que estão os novelos, donde se tiram os fios que formam o ramo da teia.
urdidura |f.| Acto ou effeito de urdir.
urdim |m.| P. us. O mesmo que urdimento.
urdimaças |m.| Pop. Pessôa intriguista e mexeriqueira. Pl. Enredos, intrigas. (De urdir ) |f.| Pop. Pessôa intriguista e mexeriqueira. Pl. Enredos, intrigas. (De urdir )
urdimalas |m.| O mesmo que urdimaças. |f.| O mesmo que urdimaças.
urdimento |m.| O mesmo que urdidura. Travejamento do tecto dos palcos, e os sótãos que lhe ficam por cima.
urdir |v. t.| Pôr por ordem ou dispor (os fios da teia), para se fazer o tecido. Fig. Enredar; intrigar. Maquinar. (Do lat. ordiri)
urdu |m.| Lı́ngua moderna da Índia, mesclada de estranjeirismos árabes e persas. O mesmo que indostano.
urdume |m.| O mesmo que urdidura.
uréa |f.| Um dos princı́pios immediatos da urina. (Cp. urina)
uredı́neo |adj.| Relativo ao uredo2 , ou parecido com elle. |F.| pl. Famı́lia de cogumelos, que têm por typo o uredo2 .
uredo #,1 (urê)# |m.| Comichão, ardor. (Lat. uredo)
uredo #,2 (urê)# |m.| Cogumelo na urina de certos oxalúricos. (Cp. urina)
ureia |f.| Um dos princı́pios immediatos da urina. (Cp. urina)
urélia |f.| Gênero de insectos dı́pteros.
uremia |f.| Estado mórbido, resultante talvez da retenção da
ureia no sangue. (Do gr. ouron + haima)
urêmico |adj.| Relativo á uremia.
urente |adj.| Que queima; ardente. (Lat. urens)
urentemente |adv.| P. us. De modo urente. Ardentemente.
ureómetro |m.| Med. Instrumento, para a dosagem da ureia. (De ureia + gr. metron)
uretana |f.| Chı́m. Carbonato anhydro de ammonı́aco e de gás oleificante.
uréter |m.| Cada um dos canaes membranosos, que conduzem a urina, dos rins para a bexiga. Pl. uretéres, como de carácter caractéres. (Gr. oureter )
urétera |f.| (V. urethra)
ureteralgia |f.| Dôr nos ureteres. (Do gr. oureter + algos)
ureterálgico |adj.| Relativo á ureteralgia.
uretére |m.| Fórma e pronúncia incorrecta, em vez de uréter. (V. uréter )
uretérico |adj.| Relativo ao uréter.
ureterite |f.| Inflammação dos ureteres. (De uréter )
ureterolithı́ase |f.| Med. Retenção de cálculos nos ureteres. (Do gr. oureter + lithos)
ureterolı́thico |adj.| Relativo á ureterolithı́ase. Produzido pela presença de cálculos nos ureteres.
ureterolitı́ase |f.| Med. Retenção de cálculos nos ureteres. (Do gr. oureter + lithos)
ureterolı́tico |adj.| Relativo á ureterolitı́ase. Produzido pelaureterostomático presença de cálculos nos ureteres.
ureterostomático |adj.| Anat. Relativo ao orifı́cio dos ureteres. Med. Causado pela obstrucção do orifı́cio dos ureteres na bexiga. (Do gr. oureter + stoma)
urethra |f.| Anat. Canal excretor da urina. (Lat. urethra)
urethral |adj.| Relativo á urethra.
urethralgia |f.| Dôr na urethra. (Do gr. ourethra + algos)
urethrálgico |adj.| Relativo á urethralgia.
urethrelmı́nthico |adj.| Med. Causado pela presença de vermes na urethra. (De urethra + helmintho)
uréthrico |adj.| O mesmo que urethral.
urethrite |f.| Inflammação da urethra.
urethrocystomia |f.| Cir. Operação da talha.
urethrolı́thico |adj.| Med. Causado pela presença de cálculos na urethra. (Do gr. ourethra + lithos)
urethrophraxia #,(csi )# |f.| Obstrucção da urethra. (Do gr. ourethra + phrassein)
urethroplástica |f.| Operação cirúrgica, com que se substitue uma parte perdida da substância da urethra. (Do gr. ourethra + plassein)
urethrópyco |adj.| Med. Causado pela accumulação de pus na urethra. (Do gr. ourethra + puon)
urethrorragia |f.| Derramamento de sangue pela urethra. (Do gr. ourethra + regnumi)
urethrorraphia |f.| Sutura de uma fenda da urethra. (Do gr. ourethra + rhaphe)
urethrorrheia |f.| Fluxo ou corrimento pela urethra. (Do gr. ourethra + rhein)
urethroscopia |f.| Observação da urethra por meio do urethroscópio.
urethroscópio |m.| Instrumento cirúrgico, para fazer observações no interior da urethra. (Do gr. ourethra + skopein)
urethróscopo |m.| (V. urethroscópio)
urethrostenia |f.| Apêrto de urethra. (Do gr. ourethra + stenos)
urethrostênico |adj.| Relativo á urethrostenia. Que soffre urethrostenia.
urethrothrombóide |adj.| Med. Causado pela presença de grumos de sangue na urethra.
urethrotomia |f.| Incisão na urethra. (De urethrótomo)
urethrótomo |m.| Instrumento, para fazer incisões na
urethra. (Do gr. ourethra + tome)
urethrovesical |adj.| Anat. Relativo á urethra e á bexiga. (De urethra + vesical )
urético |adj.| Relativo á urina; diurético. Diz-se de qualquer enfermidade do canal excretor da urina e, especialmente, de uma espécie de febres, complicada de diabete. (Do gr. ouron)
uretilana |f.| Chı́m. Carbonato anhydro de ammonı́aco e de methylena.
uretra |f.| Anat. Canal excretor da urina. (Lat. urethra)
uretral |adj.| Relativo á uretra.
uretralgia |f.| Dôr na uretra. (Do gr. ourethra + algos)
uretrálgico |adj.| Relativo á uretralgia.
uretrelmı́ntico |adj.| Med. Causado pela presença de vermes na uretra. (De uretra + helminto)
urétrico |adj.| O mesmo que uretral.
uretrite |f.| Inflamação da uretra.
uretrocistomia |f.| Cir. Operação da talha.
uretrofraxia #,(csi )# |f.| Obstrucção da uretra. (Do gr. ourethra + phrassein)
uretrolı́tico |adj.| Med. Causado pela presença de cálculos na uretra. (Do gr. ourethra + lithos)
uretrópico |adj.| Med. Causado pela acumulação de pus na
uretra. (Do gr. ourethra + puon)
uretroplástica |f.| Operação cirúrgica, com que se substitue uma parte perdida da substância da uretra. (Do gr. ourethra + plassein)
uretrorrafia |f.| Sutura de uma fenda da uretra. (Do gr. ourethra + rhaphe)
uretrorragia |f.| Derramamento de sangue pela uretra. (Do gr. ourethra + regnumi)
uretrorreia |f.| Fluxo ou corrimento pela uretra. (Do gr. ourethra + rhein)
uretroscopia |f.| Observação da uretra por meio do uretroscópio.
uretroscópio |m.| Instrumento cirúrgico, para fazer observações no interior da uretra. (Do gr. ourethra + skopein)
uretróscopo |m.| (V. uretroscópio)
uretrostenia |f.| Apêrto de uretra. (Do gr. ourethra + stenos)
uretrostênico |adj.| Relativo á uretrostenia. Que sofre uretrostenia.
uretrotomia |f.| Incisão na uretra. (De urethrótomo)
uretrótomo |m.| Instrumento, para fazer incisões na uretra. (Do gr. ourethra + tome)
uretrotrombóide |adj.| Med. Causado pela presença de grumos de sangue na uretra.
uretrovesical |adj.| Anat. Relativo á uretra e á bexiga. (De
urethra + vesical )
urge #,1 # |m.| (V. uge)
urge #,2 # |f.| (e der.) Prov. minh. O mesmo que urze, etc.
urgebão |m.| Planta verbenácea. (Do gr. hiera + botane)
urgência |f.| Qualidade do que é urgente; pressa. (Lat. urgentia)
urgente |adj.| Que urge. Que é preciso fazer-se rapidamente. Indispensável. Imminente. (Lat. urgens)
urgentemente |adv.| De modo urgente.
úrgico |adj.| Burl. O mesmo que urgente.
urgir |v. i.| Sêr necessário sem demora; não permitir demora. Instar. |V. t.| Impellir, perseguir de perto. Comprimir, impellindo. (Lat. urgere)
urgueira |f.| Prov. O mesmo que urze. Cf. Camillo, Doze Casam., 120. (Cp. urzeira)
uricana |f.| Bras. Espécie de palmeira.
uricemia |f.| Estado mórbido, manifestado por excesso de ácido úrico na urina. (De úrico + gr. haima)
úrico |adj.| Diz se de um ácido, contido nas urinas. Resultante da ureia.
urida |f.| Planta indiana, (phaseolus max ).
urim |m.| Adôrno, que o supremo sacerdote dos Judeus punha ao peito, quando tinha de consultar a Deus, nos casos mais graves de interesse público.
urina |f.| Lı́quido excrementı́cio, segregado pelos rins, donde corre pelos ureteres para a bexiga. (Lat. urina)
urinação |f.| Acto ou effeito de urinar.
urinanás |m.| Pl. Indı́genas do Norte do Brasil.
urinar |v. i.| Expellir urina pela via natural. |V. t.| * Expellir com urina ou de mistura com urina: urinar sangue. * |Fam.| Sujar com urina, expellir urina sôbre: urinar a cama.
urinário |adj.| Relativo á urina.
urinatório |m.| Neol. O mesmo que urinol.2033
urinı́fero |adj.| Que contém urina. Que conduz urina. (Do lat. urina + ferre)
urinı́paro |adj.| Que produz urina. (Do lat. urina + p[a]rere)
urinol |m.| Vaso ou lugar, preparado para nêlle se urinar; mictório. (De urina)
urinoso |adj.| O mesmo que urinário.
uriunduba |f.| O mesmo que aroeira.
urivi |m.| Armadilha, com que os Ganguelas apanham lebres e pequenos antı́lopes.
urjal |f.| Variedade de figueira algarvia.
urjamanta |f.| O mesmo que ujamanta.
urmeiro |m.| Ant. O mesmo que ulmeiro.
urna |f.| Vaso para água, entre os antigos. Vaso, em que se guardava a cinza dos mortos. Vaso ou objecto análogo, em que se recolhem os votos, num acto eleitoral ou os números de uma lotaria, rifa, etc. Vaso em fórma de urna antiga. Bot. Espécie de cápsula, coberta por um opérculo. * Chul. Chapéu alto. (Lat. urna)
urnário |adj.| Relativo ou semelhante a urna. |M.| Bot. Receptáculo da semente de alguns fungos e musgos. * Mesa, sôbre que os Romanos assentavam as vasilhas da água. (Lat. urnarium)
urnı́gero |adj.| Bot. Que tem urna, ou cápsula em fórma de
urna. (Do lat. urna + gerere)
urningo |m.| Med. Homem, que tem a aberração sexual de procurar os indivı́duos do seu sexo para a satisfação de prazezes sensuaes. Fanchono. (Desconheço a razão do termo, aventado pela Medicina italiana)
uró |m.| Árvore da Índia Portuguesa.
uro #,1 # |pref.| (designativo de urina) (Do gr. ouron)
uro #,2 # |pref.| (designativo de cauda) (Do gr. oura)
urobenzoato |m.| Chı́m. Sal, produzido pela combinação do ácido urobenzóico com uma base.
urobenzóico |adj.| Chı́m. Diz-se de um ácido, análogo ao
úrico, e que existe na urina dos animaes herbı́voros em geral.
urobilina |f.| O mesmo que urochromo.
urobrânchio #,(qui )# |adj.| Que tem as brânchias perto da cauda. (De uro 2 ... + brânchias)
urobrânquio |adj.| Que tem as brânquias perto da cauda. (De uro 2 ... + brânquias)
urocele |m.| Med. Infiltração da urina no escroto. (Do gr. ouron + kele)
urochlena |f.| Gênero de plantas gramı́neas.
uróchloa |f.| Gênero de plantas gramı́neas. (Do gr. oura + khlon)
urochroma |m.| O mesmo ou melhór que urochromo.
urochromo |m.| Substância còrante da urina. (Do gr. ouron + khroma)
urocianina |f.| Chı́m. Princı́pio imediato, mas acidental, da
urina. (Do gr. ouron + kuon)
urocistite |f.| Med. Inflamação da bexiga urinária. (Do gr. ouron + kustis)
uroclena |f.| Gênero de plantas gramı́neas.
urócloa |f.| Gênero de plantas gramı́neas. (Do gr. oura + khlon)
urócopo |m.| Gênero de insectos coleópteros clavicórneos.
urocrisia |f.| Med. Diagnóstico, feito pelo exame das urinas. (Do gr. ouron + crisis)
urocrı́tico |adj.| Relativo á urocrisia.
uropétalo
urocroma |m.| O mesmo ou melhór que urocromo.
urocromo |m.| Substância còrante da urina. (Do gr. ouron + khroma)
urocyanina |f.| Chı́m. Princı́pio immediato, mas accidental, da urina. (Do gr. ouron + kuon)
urocystite |f.| Med. Inflamação da bexiga urinária. (Do gr. ouron + kustis)
urodelo #,(dê)# |m.| Zool. Que tem cauda muito visı́vel. |M.| Batrácio, que perde as brânchias e que conserva a cauda em-quanto existe. * Pl. Ordem de batrácios, a que pertence a salamandra. (Do gr. oura + delos)
uródeos |m.| pl. Zool. Famı́lia de animaes microscópicos, cujo corpo termina por appêndice em fórma de cauda. (Do gr. oura + eidos)
urodiálise |f.| Med. Supressão da urina. (Do gr. ouron + dialusis)
urodiályse |f.| Med. Suppressão da urina. (Do gr. ouron + dialusis)
urodinia |f.| Dôr, sentida quando se urina. (Do gr. ouron + odune)
urodonte |m.| Gênero de insectos coleópteros tetrâmeros. (Do gr. oura + odous)
urodrimia |f.| Med. Acrimónia da urina.
urodynia |f.| Dôr, sentida quando se urina. (Do gr. ouron + odune)
uroeritrina |f.| Matéria còrante, vermelha, da urina. (Do gr. ouron + eruthros)
uroerythrina |f.| Matéria còrante, vermelha, da urina. (Do gr. ouron + eruthros)
urofilo |m.| Gênero de plantas rubiáceas. (Do gr. oura + phullon)
urófora |f.| Gênero de insectos dı́pteros. Gênero de insectos hemı́pteros. (Do gr. oura + phoros)
urohyal |m.| Anat. Peça, situada detrás do entohyal. (De
uro 2 ... + hyal )
uroial #,(o-i )# |m.| Anat. Peça, situada detrás do entoial. (De
uro 2 ... + hyal )
urolı́thico |adj.| Chı́m. Epı́theto, que se dá, ás vezes, ao ácido úrico, porque se encontra em muitos cálculos urinários. (Do gr. ouron + lithos)
urólitho |m.| Med. Cálculo urinário. (Do gr. ouron + lithos)
urolı́tico |adj.| Chı́m. Epı́teto, que se dá, ás vezes, ao ácido
úrico, porque se encontra em muitos cálculos urinários. (Do gr. ouron + lithos)
urólito |m.| Med. Cálculo urinário. (Do gr. ouron + lithos)
urologia |f.| Tratado da urina, da sua constituição e das suas alterações mórbidas. (Do gr. ouron + logos)
urológico |adj.| Relativo á urologia.
uromancia |f.| Arte de conhecer as enfermidades pelo aspecto da urina. (Do gr. ouron + manteia)
uromeila |f.| Monstruosidade de urómelo.
uromelanina |f.| O mesmo que ı́ndigo. (Do gr. ouron + melas)
uromeliano |adj.| Relativo ao urómelo ou á uromelı́a.
uromélico |adj.| Que apresenta os caracteres do urómelo.
urómelo |m.| Monstro, cujos membros estão reunidos num só, terminado por um pé. (Do gr. oura + melos)
urómetro |m.| Med. Instrumento, que deixa conhecer o pêso especı́fico da urina. (Do gr. ouron + metron)
uropéstide |m.| Gênero de reptı́s ophı́dios.
uropétalo |m.| Gênero de plantas liliáceas. (Do gr. oura +uróphora petalon) da urina. (Do gr. ouron + xanthos)
uróphora |f.| Gênero de insectos dı́pteros. Gênero de insec-urraca |f.| Náut. Apparelho das velas do estai, entre os mastos hemı́pteros. (Do gr. oura + phoros)
urophyllo |m.| Gênero de plantas rubiáceas. (Do gr. oura + phullon)
uropigial |adj.| Relativo ao uropı́gio.
uropı́gio |m.| Saliência triangular sôbre as vértebras inferiores das aves, e da qual nascem as pennas da cauda. (Do gr. oura + puge)
uroplania |f.| Med. Apparecimento da urina em qualquer parte do corpo, onde ella é anómala. (Do gr. ouron + plane)
uropo |m.| Gênero de insectos lepidópteros nocturnos. (Cp. urópodes)
urópoda |f.| Gênero de arachnı́deos. (Cp. urópodes)
urópodes |m.| pl. Famı́lia de aves palmı́pedes, cujos pés estão tanto para trás, que faz parecer que essas aves andam sôbre a cauda. (Do gr. oura + pous, podos)
uropoése |f.| Producção da urina. (Do gr. ouron + poiesis)
uropoético |adj.| Relativo á uropoése. Que favorece ou promove a uropoése.
urópteros |m.| pl. Zool. Famı́lia de crustáceos amphı́podes. (Do gr. oura + pteron)
uropygial |adj.| Relativo ao uropýgio.
uropýgio |m.| Saliência triangular sôbre as vértebras inferiores das aves, e da qual nascem as pennas da cauda. (Do gr. oura + puge)
uroque |m.| O mesmo ou melhor que auroque. (Cp. uro)
urorragia |f.| Designação imprópria da urorrheia.
urorreia |f.| Med. Fluxo abundante de urina; diabete. (Do gr. ouron + rhein)
urorrhagia |f.| Designação imprópria da urorrheia.
urorrheia |f.| Med. Fluxo abundante de urina; diabete. (Do gr. ouron + rhein)
uroscopia |f.| Exame das urinas. (Do gr. ouron + skopein)
uroscópico |adj.| Relativo á uroscopia.
uróscopo |adj.| Diz-se do médico, que observa as urinas de
um enfermo, para que, combinada essa observação com outros phenómenos, possa, estabelecer o diagnóstico. (Do gr. ouron + skopein)
urose |f.| Qualquer doença das vias urinárias. (Do gr. ouron)
urosemiologia #,(se)# |f.| Tratado dos symptomas das doenças urinárias. Cf. Verg. Machado, Urosemeiologia. (De
uro + semeiologia)
urosemiológico #,(se)# |adj.| Relativo á urosemeiologia.
uroseptina #,(sé)# |f.| Preparação antiséptica, em que entra
urotropina, piperasina, benzoato de soda e benzoato de lithina. (Do gr. ouron + septikos)
urospermo |m.| Gênero de plantas synanthéreas. (Do gr. oura + sperma)
urossemiologia |f.| Tratado dos symptomas das doenças
urinárias. Cf. Verg. Machado, Urosemeiologia. (De uro... + semeiologia)
urossemiológico |adj.| Relativo á urossemeiologia.
urosseptina |f.| Preparação antiséptica, em que entra
urotropina, piperasina, benzoato de soda e benzoato de lithina. (Do gr. ouron + septikos)
urotropina |f.| Medicamento diurético, para a diátese úrica.
uroxanthina #,(csan)# |f.| Chı́m. Matéria còrante, amarela, da urina. (Do gr. ouron + xanthos)
uroxantina #,(csan)# |f.| Chı́m. Matéria còrante, amarela,tros. Pop. O mesmo que pêga 1 . (De Urraca, |n. p.| )
urrar |v. i.| Dar urros; rugir. |V. t.| Exprimir, á maneira de
urro. (It. urlare)
urreiro |m.| Prov. dur. (V. orreiro)
urrhodina |f.| O mesmo que urochromo.
urro |m.| Rugido ou voz forte de algumas feras. Fig. Berro. (De urrar )
urrodina |f.| O mesmo que urocromo.
urrosacina |f.| Chı́m. Substância orgânica, que só se dissolve em grande porção de água, e cuja côr varı́a do rosado para o encarnado tirante a escuro. (Do rad. de urina e do lat. rosaceus)
ursa |f.| Fêmea do urso. Nome de duas constellações boreaes, que se distinguem por Ursa-maior e Ursa-menor. (Lat. ursa)
urselo #,(sê)# |m.| Prov. trasm. Urso pequeno.
ursı́deo * |adj.| Relativo ou semelhante ao urso. |M.| pl. Famı́lia de mammı́feros, a que pertence o urso. (De urso + gr. eidos)
ursino |adj.| Relativo ao urso. (Lat. ursinus)
urso |m.| Gênero de animaes carnı́voros. Fig. Homem pouco sociável, intratável. Homem feio. Escol. Estudante premiado ou distinto. |Fam.| Indivı́duo que é objecto de zombaria. * Bras. da Baı́a. Mandatário de assassı́nios. (Lat. ursus)
ursulina |f.| Nome de freiras, que se encarregavam especialmente da instrucção de meninas e pertenciam á Ordem de Santo Agostinho. Pl. Convento de ursulinas. (Do nome de Santa Úrsula)
urticação |f.| Acto de flagellar a pelle, para a excitar. (Do lat. urtica)
urticáceas |f.| pl. Famı́lia de plantas, que tem por typo a urtiga.
urticante |adj.| Que produz sensação análoga á das urtigas sôbre a pelle. (De urticar )
urticar |v. t.| Produzir sensação análoga á das urtigas sôbre (a pelle). Cf. Fil. Simões, Cartas da Beir., 206. (Lat. urticare)
urticária |f.| Med. Inflammação, caracterizada por manchas, raramente persistentes, e que produz um prurido semelhante ao que a urtiga produz sôbre a pelle. (Lat. urticaria)
urtı́ceas |f.| pl. (V. urticáceas)
urticifoliado |adj.| Bot. Que tem fôlhas parecidas com as da urtiga. (Do lat. urtica + folium)
urticı́neas |f.| pl. Ordem de plantas, que contém as urticáceas e outras famı́lias. (Do lat. urtica)
urtiga |f.| Gênero de plantas bravas, em que se distingue a
urtiga commum, cuja haste e cujas fôlhas produzem na pelle um ardor especial. * Peixe dos Açores. (Do lat. urtica)
urtiga-branca |f.| O mesmo que urtiga-morta.
urtiga-da-china |f.| Nome de várias plantas urticáceas, de filamentos têxteis.
urtiga-de-cipó |f.| Planta euphorbiácea do Brasil.
urtiga-de-espinho |f.| Planta escrofuları́nea do Brasil.
urtiga-do-mar |f.| Nome da alforreca e de outros acalephos, bem como de alguns pólypos.
urtiga-do-papel |f.| Planta têxtil urticácea.2035
urtiga-morta |f.| Planta labiada, também conhecida por lâmio-branco.
urtigação |f.| Acto de urtigar.
urtigal |m.| Lugar, onde crescem urtigas.
urtigão |m.| Espécie de urtiga, (urtica dioica, Lin.).
urtigar |v. t.| Picar ou flagellar com urtigas. (Do lat. urticare)
urtigueira |f.| O mesmo que urtigal. Urtiga grande.
uru #,1 # |m.| Bras. Ave gallinácea do Brasil. (T. tupi)
uru #,2 # |m.| Cesto de palha, em que os Indı́genas do Brasil guardam cachimbos, tabaco, anzóis, e outros objectos.
urubá |f.| Planta amarantácea do Brasil.
urubu |m.| Pequeno abutre da América. Nome de outras aves de rapina. * Bras. Fig. Grande usurário; financeiro, que enriquece illicitamente. * Bras. Espécie de mandioca, de raı́z curta e grossa. * Bras. Árvore silvestre, que dá tinta roxa. * Bras. Serviçal, que acompanha os enterros, de tocha na mão.
urubu-cáa |m.| Planta aristolóchia do Brasil.
urubu-rei |m.| Bras. Espécie de ave grande, formosa e rara.
urubus |m.| Pl. Indı́genas do Norte do Brasil.
urucabaca |f.| Bras. riograndense Caiporismo; má sorte.
urucaiana |f.| Bras. Espécie de onça.
urucari |m.| Espécie de palmeira do Brasil. Fruto dessa árvore. * Caroço dêsse fruto, que se queima para defumar o leite da siringueira.
urucatu |m.| Planta amaryllı́dea do Brasil.
urucongo |m.| Bras. O mesmo que urucungo.
uruçu |m.| Bras. Grande abelha avermelhada e inoffensiva.
urucuana |f.| Árvore euphorbiácea do Brasil.
urucubaca |f.| Bras. do N. Feitiçaria.
uruçuca |f.| Bras. Árvore silvestre.
urucueiro |m.| Arbusto brasileiro, cuja semente é revestida de uma polpa avermelhada a que se chama urucu. (De urucu)
uruçuı́ |m.| Bras. Pequenina abelha amarela. (Dem. de uruçu)
urucungo |m.| Bras. Grosseiro instrumento músico, usado pelos Negros.
urucurana |f.| Bras. Árvore silvestre, de bôa madeira para construcções.
urucuranis |m.| Pl. Trı́bo de Índios do Brasil, em MatoGrosso.
urucuri |m.| Palmeira, o mesmo que urucari.
urucutufus |m.| Pl. Bras. Índios das margens de um affluente da Madeira.
urucuuba |f.| O mesmo que urucueiro.
urucuzeiro |m.| O mesmo que urucueiro.
uruguaiano |adj.| Relativo ao Uruguai. |M.| Habitante do Uruguai.
uruguaio |m.| Bras. O mesmo que uruguaiano. |adj.| Bras. O mesmo que uruguaiano.
uruiauara |f.| Bras. Espécie de onça.
urumbamba |f.| Bras. Espécie de palmeira.
urumbeba |f.| O mesmo que cumbeba.
urumbebal |m.| Terreno, plantado de urumbebas.
urumutum |m.| Bras. Ave gallinácea da América. (Do tupi)
urupás |m.| Pl. Indı́genas do Norte do Brasil.
urupé |m.| Bras. Espécie de cogumelo.
urupema |f.| Bras. Espécie de joeira de palha de cana, para peneirar farinha de mandioca.
urupemba |f.| O mesmo que urupema.
ussu
ururau |m.| Bras. Espécie de lagarto voraz. (Alter. do tupi ururá)
ururi |m.| Fruto silvestre do Brasil.
úrus |m.| (V. uro)
urussacanga |m.| Bras. Grande cesto, o mesmo que aturá.
urutago |m.| Bras. O mesmo que urutau? Cf. Júl. Ribeiro, Padre Belch., 168: “...o regougo de um urutago...”
urutau |m.| Bras. Ave nocturna de rapina. (T. tupi)
urutu |m.| Bras. Espécie de cobra muito venenosa, (lachesus alternatus).
uruxi |m.| Ant. Espécie de verniz do Japão.
urvı́lea |f.| Gênero de plantas sapindáceas. (De Urville, |n. p.| )
urzal |m.| Terreno, onde crescem urzes. Matagal pouco crescido.
urze |f.| Planta ericı́nia. Torga, queiró. Espécie de uva do Doiro. * Árvore açoreana, (erica azorica). * Casta de uva branca da região do Doiro. (Do lat. ulex )
urze-branca |f.| Espécie de urze arbustiva, (erica arborea, Lin.).
urze-das-vassoiras |f.| Planta ericácea, (erica scoparia, Lin.).
urzeira |f.| O mesmo que urzal.
urzeiro |m.| Urze arbustiva.
urzela |f.| Espécie de lı́chen tinctorial. (Do it. oricello. Cp. cast. orchilla)
urzelina |f.| Açor. Terreno, semeado de urzela.
urzella |f.| Espécie de lı́chen tinctorial. (Do it. oricello. Cp. cast. orchilla)
urzellina |f.| Açor. Terreno, semeado de urzella.
urzibelha #,(bê)# |f.| Prov. trasm. Arbusto, o mesmo que chaguarço. (Affinidade com urgebão?)
usado |adj.| Acostumado. Deteriorado, gasto. (De usar )
usagem |f.| Des. Uso. Direito, baseado no uso. (De usar )
usai-della |f.| Açor. O mesmo que erva-formigueira.
usança |f.| Uso. Hábito antigo. Costumeira. (De usar )
usar |v. t.| Praticar: usar um offı́cio. Têr por costume:
usar mentir. Empregar. Vestir, trajar. Trazer por hábito. Deteriorar; cotiar. |V. i.| Estar acostumado. Servir-se. (De uso)
usável |adj.| Que se póde usar. * Ant. O mesmo que usual.
useiro |adj.| Que costuma fazer alguma coisa. Que tem por
uso alguma coisa. (De uso)
usitar |v. t.| O mesmo que usar ; empregar com frequência. Cf. Castilho, Camões. (Lat. usitare)
usmar |v. t.| (e der.) Corr. trasm. de esmar, etc.
usmeira |adj.| Prov. trasm. Diz-se da mulhér, que é useira em qualquer coisa. (De usmar ?) |f.| Prov. trasm. Diz-se da mulhér, que é useira em qualquer coisa. (De usmar ?)
úsnea |f.| Gênero de lı́chens tinctoriaes; penugem. (Do ár. ashnah)
uso |m.| Acto ou effeito de usar. Moda. Emprêgo de qualquer coisa; applicação; serviço: esta loiça tem muito uso. Cotio. Experiência. (Lat. usus)
ussa |f.| Planta africana, herbácea, ornamental, de fôlhas simples, levemente recortadas, e flôres vermelhas, inodoras.
ússar |m.| O mesmo ou melhór que hússar. Cf. Rui Barb., Réplica, 158.
ussia |f.| (V. adussia)
usso |m.| Ant. O mesmo que urso. Cf. Eufrosina, 126; Usque, 17.
ussu |adj.| O mesmo que guassu ou guaçu.ussubi
ussubi |m.| Árvore da ilha de San-Thomé.
ustão |f.| Acto ou effeito de queimar. Cauterização. Combustão. (Do lat. ustio)
uste |m.| Us. na |loc.| proverbial: quem quer uste, que lhe custe, isto é, quem quer riquezas, que labute. Cf. Sim. Mach., |f.| 68, v.º
ustéria |f.| Gênero de plantas liliáceas.
ustório |adj.| Que queima; que facilita a queimadura. (Do lat. ustor )
ustrina |f.| Lugar, onde os Romanos queimavam os cadáveres, na occasião do funeral. (Lat. ustrina)
ustulação |f.| Acto ou effeito de ustular. (Lat. ustulatio)
ustular |v. t.| Queimar ligeiramente. Secar ao fôgo. (Lat. ustulare)
usual |adj.| Que se usa geralmente; habitual; frequente. (Lat. usualis)
usualmente |adv.| De modo usual; commummente; em geral; vulgarmente.
usuano |adj.| (?) “...da usuana da Serpente que lá no Brasil serve de carruagem...” Anat. Joc. II, 445.
usuário |m.| O que possue ou frue alguma coisa por direito que provém do uso. * Que serve para nosso uso. Dizia-se do escravo, de que só se tinha o uso e não a propriedade. (Lat. usuarius) |adj.| O que possue ou frue alguma coisa por direito que provém do uso. * Que serve para nosso uso. Dizia-se do escravo, de que só se tinha o uso e não a propriedade. (Lat. usuarius)
usucapião |m.| Jur. Modo antigo de adquirir propriedade, pela posse pacı́fica durante certo tempo. Espécie de prescripção. (Lat. usucapio)
usucapiente |m.| O que usucapiu. (Lat. usucapiens) |adj.| O que usucapiu. (Lat. usucapiens)
usucapir |v. t.| Jur. Adquirir pelo usucapião. (Lat. usucapere)
usucapto |adj.| Adquirido por usucapião. (Lat. usucaptus)
usufructo |m.| Acto ou effeito de usufruir; aquillo que se
usufrue. Direito, proveniente do usufructo; fruição. (Lat. usufructus)
usufructuar |v. t.| O mesmo que usufruir. (De usufructo)
usufructuário |adj.| Relativo ao usufructo. |M.| Aquelle que
usufrue. (Lat. usufructuarius)
usufructueiro |adj.| O mesmo que usufructuário. Cf. Camillo, Sc. da Foz, 198.
usufruição #,(fru-i )# |f.| Acto ou effeito de usufruir.
usufruir |v. t.| Têr a posse e o gôzo de (alguma coisa que se não póde alienar ou destruı́r). (Do lat. usus + frui)
usufruto #,1 # |m.| Acto ou efeito de usufruir; aquilo que se
usufrue. Direito, proveniente do usufruto; fruição. (Lat. usufructus)
usufruto #,2 # |m.| (e der.) O mesmo ou melhór que usufructo, etc.
usufrutuar |v. t.| O mesmo que usufruir. (De usufruto)
usufrutuário |adj.| Relativo ao usufruto. |M.| Aquele que
usufrue. (Lat. usufructuarius)
usufrutueiro |adj.| O mesmo que usufrutuário. Cf. Camillo, Sc. da Foz, 198.
usura |f.| Juro de um capital. Juro de dinheiro que se emprestou. Contrato de empréstimo, com a cláusula do pagamento de juros por parte do devedor. Juro excessivo; lucro exaggerado. (Lat. usura)
usurar |v. i.| Des. Emprestar dinheiro ou outras coisas com usura.
usurariamente |adv.| Com usura. (De usurário)
usurário |adj.| Que empresta com juro excessivo. Que tem o carácter da usura ou é acompanhado por ella. |M.| Aquelle que empresta com usura ou com juro excessivo. Pop. Agiota; avarento. (Lat. usurarius)
usureiro |m.| (V. usurário). Cf. Luz e Calor, 51. |adj.| (V. usurário). Cf. Luz e Calor, 51.
usurpação |f.| Acto ou effeito de usurpar. (Do lat. usurpatio)
usurpador |m.| O que usurpa; intruso. (Lat. usurpator ) |adj.| O que usurpa; intruso. (Lat. usurpator )
usurpar |v. t.| Apoderar-se violentamente de. Adquirir fraudulentamente. Obter sem direito: usurpar um throno. (Lat. usurpare)
ut #,(ud’ )# |m.| Ant. Primeira nota da escala musical, hoje substituı́da por dó. (Cp. fá)
utar |v. t.| (V. outar )
utata |f.| Árvore angolense de Caconda.
utena |f.| Pássaro dentirostro africano.
utênsil |m.| O mesmo que utensı́lio. Cf. Filinto, IX, 72. (Lat. utensilis)
utensı́lio |m.| Qualquer instrumento de trabalho, de que se serve um artista ou um industrial. Objecto, que serve de meio ou instrumento para se fazer qualquer coisa: utensı́lios de cozinha. (Do lat. hyp. utensilium)
utente |adj.| Que usa. (Lat. utens)
uteralgia |f.| Dôr no útero. (De útero + gr. algus)
uteremia |f.| Congestão sanguı́nea do útero. (De útero + gr. haima)
uterino |adj.| Relativo a útero. (Lat. uterinus)
útero |m.| Órgão, em que se gera o féto dos mammı́feros; madre. (Lat. uterus)
utero-placentário |adj.| Anat. Relativo ao útero e á placenta.
utero-vaginal |adj.| Anat. Relativo ao útero e á vagina.
uteróceps |m.| Cir. Instrumento, com que se apprehende o collo do útero. (Do lat. uterus + capere)
uteromania |f.| O mesmo que nymphomania. (De útero + mania)
uterorragia |f.| O mesmo que metrorragia. (De útero + gr. regnumi)
uterorrhagia |f.| O mesmo que metrorrhagia. (De útero + gr. regnumi)
uteroscopia |f.| Observação do útero, por meio de instrumentos apropriados. (De útero + gr. skopein)
uterostomátomo |m.| Cir. Instrumento, para a incisão dos bordos do collo do útero, quando se manifestam convulsões na occasião do parto. (T. hybr., do lat. uterus + gr. stoma + tome)
uterotomia |f.| Incisão do collo do útero. (De uterótomo)
uterotómico |adj.| Relativo á uterotomia.
uterótomo |m.| Instrumento, com que se opera a uterotomia. (De útero + gr. tome)
uteruéria |f.| Gênero de plantas capparı́deas.
uticense |adj.| Relativo a Útica. |M.| Habitante de Útica.– Além da cidade africana célebre pelo suicı́dio de Catão, há hoje outra cidade do mesmo nome na América no Norte. Cf. Eufrosina, 98. (Lat. uticensis)
útil |adj.| Que póde têr algum uso, ou que serve para alguma coisa. Vantajoso. Em que se póde trabalhar, (falando-se de certos dias). Determinado por lei. |M.| Des. Utilidade; aquillo que é útil: “...que não havia uteis que equivalessem aos riscos...” Filinto, D. Man., I, 48. (Lat. utilis)
utilidade |f.| Qualidade do que é útil. Serventia. Vantagem. Pessôa ou coisa útil. (Do lat. utilitas)2037
utilitariamente |adv.| De modo utilitário. Com feição prática ou positiva. Por interesse.
utilitário |adj.| Relativo a utilidade. |M.| Aquelle que tem a
utilidade ou o interesse como fim principal dos seus actos. (Do lat. utilitas)
utilitarismo |m.| Systema dos utilitários.
utilitarista |m.| Partidário do utilitarismo.
utilização |f.| Acto ou effeito de utilizar.
utilizar |v. t.| Tornar útil. Aproveitar. Empregar com vantagem. |V. i.| Sêr útil: a má lingua não utiliza a ninguém. |V. p.| Lançar mão; tirar proveito: utilizar-se da ignorância alheia.
utilizável |adj.| Que se póde utilizar.
utilmente |adv.| De modo útil; com vantagem; com interesse.
utopia |f.| Paı́s imaginário, em que tudo está organizado da melhór fórma. Fig. Plano de govêrno, de que resultaria a felicidade pública, se êlle fosse exequı́vel. |Ext.| Projecto imaginário. Systema ou ideia irrealizável; fantasia. (Do gr. ou + topos)
utópico |adj.| Relativo a utopia.
utopista |adj.| O mesmo que utópico. |M.| Pessôa, que fórma ou defende utopias. (De utopia) |f.| Pessôa, que fórma ou defende utopias. (De utopia)
utopı́stico |adj.| Próprio de utopista.
utota |f.| Árvore africana, de tronco tortuoso, fôlhas sempre verdes, glabras, lisas, e flôres completas, gamopétalas.
utre |m.| (Fórma pop. de útero)
utricular |adj.| Semelhante a um utrı́culo.
utriculária |f.| Gênero de plantas herbáceas e aquáticas. (De utrı́culo)
utriculariáceas |f.| pl. Famı́lia de plantas, que têm por typo a utriculária. (Fem. pl. de utriculariáceo)
utriculariáceo |adj.| Relativo ou semelhante á utriculária.
utriculariadas |f.| pl. (V. utriculariáceas)
utriculariforme |adj.| O mesmo que utricular.
utricuları́neas |f.| pl. O mesmo que utriculariáceas.
utriculário |m.| Nome, que se deu, entre os antigos, ao tocador de cornamusa ou de gaita de folles. (Lat. utricularius)
utrı́culo |m.| Pequeno saco. Bot. Cada uma das céllulas de tecido cellular dos vegetaes. Anat. A maior porção de labyrintho membranoso do ouvido. Bot. Cavidade dos órgãos pollı́nicos. (Lat. utriculus)
utriculoso |adj.| Que tem utrı́culos.
utriforme |adj.| Que tem fórma de odre. (Do lat. uter + forma)
utuaba |f.| Planta meliácea do Brasil.
utuapoca |f.| Planta meliácea do Brasil.
utuaúba |f.| O mesmo que utuaba.
uuçango |m.| Árvore de Angola.
uussango |m.| Árvore de Angola.
uva |f.| Nome do bago, que é o fruto da videira. Conjunto dêsses frutos, constituindo um cacho. Conjunto dos frutos de uma videira. Designação genérica dos fructos das vinhas: este anno, a uva soffreu muito com o calor. (Lat. uva)
uva-açu |f.| Planta palmácea, da América meridional, (manicaria saccifera).
uva-aia |f.| Bras. Árvore fructı́fera, (eugenia arrabidae, Berg.).
uva-crespa |f.| O mesmo que groselheira.
uva-da-promissão |f.| Variedade de uva branca.
uva-da-promissão-roxa |f.| Casta de uva de Castello de
uvre Vide. Cf. Rev. Agron., I, 18.
uva-de-cão |f.| Planta solânea, (solanum dulcamara). Variedade de uva miúda e azêda.
uva-de-cheiro |f.| Designação popular da uva isabel. (Cp. isabel )
uva-de-gallo |m.| O mesmo que coração-de-gallo.
uva-de-joão-paes |f.| O mesmo que escabellado.
uva-de-obó |f.| Planta medicinal da ilha de San-Thomé.
uva-de-rei |f.| Casta de uva trasmontana.
uva-de-urso |f.| Planta, o mesmo que uva-ursina.
uva-do-inferno |f.| Variedade de uva minhota, muito resistente e branca.
uva-do-inverno |f.| Variedade de uva minhota, muito resistente e branca.
uva-do-mato |f.| Planta cordiácea, (cordia argentea).
uva-do-monte |f.| Árvore ericácea, o mesmo que arando.
uva-do-nascimento |f.| Casta de uva Penafiel. Cf. Rev. Agron., I, 18.
uva-espim |f.| Planta berberı́dea, (berberis vulgaris).
uva-espinha |f.| O mesmo que groselheira.
uva-gorda |f.| Casta de uva do districto de Leiria.
uva-maçan |f.| Casta de uva de Azeitão. Cf. Rev. Agron., I, 18.
uva-purama |f.| Planta myrtácea, (myrtus racemosa).
uva-rara |f.| Casta de uva brasileira.
uva-rei |f.| Variedade de uva, o mesmo que moirisco.
uva-ursina |f.| Planta ericácea, (arctostaphylos uva-ursi, Lin.).
uvaça |f.| Grande porção de uvas.
uvacupari |f.| Bras. Árvore fructı́fera dos sertões.
uvada |f.| Conserva de uvas.
uvaia |f.| Bras. Fruta da uvaieira. (Do tupi)
uvaieira |f.| Bras. Planta myrtácea da América, (eugenia
uvaia). (De uvaia)
uval |adj.| Relativo á uva. |M.| Pop. Tumores hemorrhoidaes.
uvalha |f.| Planta myrtácea. (De uva)
uvalheira |f.| O mesmo que uvalha.
uvapiritica |f.| Bras. Planta, semelhante ao morangueiro.
uvária |f.| Gênero de plantas anonáceas, cujo fruto é febrı́fugo. (De uva)
uvarovito |m.| Miner. Variedade de granada verde, que se encontra na Sibéria.
úvea |f.| Conjunto das partes do ôlho, representadas pela choróide, pela ı́ris e pelos processos ciliares. Ant. Choróide, ou a face posterior da ı́ris. (Do lat. uva)
uvedália |f.| Gênero de plantas escrofuları́neas.
uveira |f.| Árvore, a que se prendem braços de videira. (De uva)
uveı́ta |m.| Membro de uma Ordem de austeros anachoretas muçulmanos, fundada em 667.
uveı́te |f.| Inflammação da úvea.
uviar |v. i.| Prov. trasm. O mesmo que uivar. (Metáth. de
uivar )
úvico |adj.| O mesmo que tartárico 2 . (De uva)
úvido |adj.| O mesmo que húmido. (Lat. uvidus)
uvı́fero |adj.| Que dá frutos semelhantes ao cacho de uvas. (Lat. uvifer )
uviforme |adj.| Semelhante a um bago de uva. (Do lat. uva + forma)
uvre |m.| Ant. O mesmo que úbere. Cf. B. Pereira, Prosódia, vb. sumen.úvula
úvula |f.| Anat. Saliência cónica, na parte posterior do véu palatino. (Lat. uvula)
uvular |adj.| Relativo á úvula.
uvulária |f.| Gênero de plantas melantháceas. (De úvula)
uvulário |adj.| O mesmo que uvular.
uvuliforme |adj.| Semelhante á úvula. (De úvula + fórma)
uvulite |f.| Med. Inflammação na úvula.
uxi |m.| Grande árvore rosácea. * Designação de vários frutos silvestres do Norte do Brasil.
uxim |m.| Variedade de chá.
uxirana-da-várzea |f.| Bras. do N. Árvore para construcções.
uxoricida #,(cso)# |m.| Aquelle que assassinou sua mulhér. Cf. Camillo, Corja, 167. (Cp. uxoricı́dio)
uxoricı́dio #,(csi )# |m.| Assassı́nio de uma mulhér, commetido por seu marido. Cf. Camillo, Caveira, 472. (Do lat.
uxor + caedere)
uxório #,(csó)# |adj.| Relativo a mulhér casada. (Lat. uxorius)
uxte! |interj.| Ant. Apre! arreda! t’arrenego! Cf. G. Vicente, I, 267. (É affim de uste?)
uzagre |m.| O mesmo ou melhór que usagre. (Cp. zagre)
uzı́fur |m.| Vermelhão, feito de enxôfre e mercúrio. O mesmo que cinábrio.
uzı́furo |m.| O mesmo ou melhór que uzı́fur. (Cp. cast. uzı́fero)