//ignorar tudo que estiver dentro de ##
//considerar que algumas entradas são duplicadas
//arrumar crase para 'á ' e 'ás'

a-pela-manhan | adv. | Prov. trasm. O mesmo que amanhan.
a-primas |loc. adv.| Ant. Em primeiro lugar.
a-prop´osito |loc. adv.| Em occasi˜ao opportuna; convenientemente; a talho de foice.
´a-qui-qui#, (cu-i-cu-i )# |adv.| Chul. Isso mesmo, exactamente.
a-tempo |loc. adv.| Opportunamente. Em bˆoa hora. M. Opportunidade, ensejo.
´a-tˆoa |loc. adv.| Sem reflex˜ao. Ao acaso.
´a-xis |m.| Ant. O abecˆe, o princ´ıpio das coisas: “farteei tornar ao axis”. Chiado, Obras, 187. “Quando V. M. pegou no a. x., j´a eu tinha de c´or...” J. Daniel, Casa de Pasto.
aa#, (´as)# |m.| pl. Caracteres, que pluralizam a representa¸c˜ao phon´etica da primeira letra do alphabeto.
aacima |adv.| Ant. Finalmente; em conclus˜ao.
aal |m.| ´Arvore terebinth´acea, cuja casca aromatiza o vinho.
aalˆenio |m.| e adj. Geol. Diz-se do terreno que predomina nas cercanias de Aalen, (Alemanha).
aata |f.| Bras. Canˆoa de casca de madeira, com as extremidades achatadas em f´orma de bico de pato. (Do tupi aa, mal e at´a, andar).
aaz |f.| Ant. Ala, acampamento. Companhia, communidade. (Do lat. acies).
ab#...# |pref.| (que designa intens˜ao, separa¸c˜ao, opposi¸c˜ao). (Do lat. ab).
ab´a |m.| Manto de beduinos.
aba#,1#| f.| Extremidade (de alguns vestidos). Prolongamento dos lados de um corpo ou superf´ıcie: a aba do chap´eu. Pe¸ca saliente, em certas obras de carpintaria, alvenaria e serralharia. Vizinhan¸ca, sop´e: na aba da serra.
aba#,2# |m.| T´ıtulo do Bispo em algumas Igrejas orientaes. (Do syr. abba).
abab´as |m.| pl. Aborigenes do Brasil, que habitaram Mato Grosso.
abac´a |m.| Esp´ecie de bananeira, tamb´em conhecida por cˆofo. Fibra dessa planta.
abacamartado |adj.| Parecido com um bacamarte: “uma cravina abacamartada.” (De um testamento de 1693)
aba¸canar |v. t.| (V. abacinar ).
abacate |m.| Fruto do abacateiro. * O mesmo que abacateiro.
abacateiro |m.| ´Arvore tropical, de fruto comest´ıvel.
abacatina |f.| Peixe do Brasil.
abacatirana |f.| Arvore laur´acea do Brasil.
abacaxi |m.| Esp´ecie de anan´as, (bromelia ananas, Lin.)
abacelado |adj.| Convertido em bacello. Plantado de bacello: encosta abacellada.
abacelamento |m.| Acto ou effeito de abacellar.
abacelar |v. t.| Converter em bacello. Plantar de bacello.
abacellado |adj.| Convertido em bacello. Plantado de bacello: encosta abacellada.
abacellamento |m.| Acto ou effeito de abacellar.
abacellar |v. t.| Converter em bacello. Plantar de bacello.
abaceto#, (cˆe)# |m.| Gˆenero de cole´opteros pentˆameros.
abacial |adj.| Que diz respeito ao abbade ou ´a abbadia. (Do b. lat. abbatialis).
abacinar |v. t.| Tornar escuro, privar da claridade. Arroxear (a pelle). (Do b. lat. abacinare).
abacista |m.| O que trabalhava ou estudava no ´abaco. (B. lat. abacista).
´abaco |m.| Archit. Parte superior do capitel, em que assenta a architrave. Quadro antigo, em que se inscreviam os algarismos, para ensinar a calcular. Antigo bufete ou aparador. * Artilh. Desenho, para se fazerem certos c´alculos, em problemas de tiro, n˜ao por n´umeros, mas por linhas. (Lat. abacus).
abactor |m.| Ladr˜ao de gados. (Lat. abactor ).
ab´aculo |m.| Pequeno ´abaco, antiga mesa pequena. Pedra variegada, usada pelos Romanos em certos jogos. Cubo de tijolo ou vidro, pintado e embutido em pavimentos de mosaico.
abacutaia |f.| Peixe do Brasil.
abada#,1#| f.| Aba cheia; grande quantidade: trazia abadas de rosas. (De aba).
abada#,2#| f.| Fˆemea do rhinoceronte; pachiderme, an´alogo `aquelle. (Do mal. badaq, rhinoceronte).
abadado |m.| Ant. O mesmo que abbadia.
abad´agio |m.| Refei¸c˜ao, que os parochianos eram obrigados a dar ao abbade.
abadalassa |m.| Jˆogo antigo. Cf. Cancion. Ger., I, 146.
abadar |v. t.| Prover de abbade.
abadavina |f.| P´assaro conirostro.
abade |m.| Prelado de ordem mon´astica. Aquelle que governa uma abbadia. Cura de almas, p´arocho. (Do b. lat. abbas).
abadec´ıdio |m.| Assassinio de abbade. Cf. B. Pato, Ciprestes, 107.
abadejo |m.| O mesmo que badejo. Prov. O mesmo que vaca-loira.
abadengo| m.| Ant. Legado pio ou esmola, que se dava em vida ou se deixava por morte ao confessor. O antigo direito de sˆer abbade de alguma igreja. Adj. Relativo ao territ´orio ou ´a jurisdic¸c˜ao de abbade.
abadernar |v. t.| N´aut. Apertar com badernas.
abadesco |adj. |Pr´oprio de abbade.
abadessa |f.| Prelada de communidade religiosa. (Do b. lat. abbatissa).
abadessado |m.| Cargo de abbadessa. O tempo que dura esse cargo. As festas, com que se elege a abbadessa.
abadessona |f.| Fam. Abbadessa muito encorpada. Cf. Garrett, Flores, 95.
abadia |f.| Igreja, regida por abbade. Par´ochia. Rendimento do abbade.
abadiado |m.| O mesmo que abbadia.
abadim |m.| Ant. Lugar, habitado por observantes religiosos. (De abbade).
abadir |m.| Pedra, que, segundo a Mythologia, Saturno enguliu, enganado por sua mulher. Cf. Castilho, Fastos, II, 251. O mesmo que b´etylo. (Lat. abadir ).
abado#, (`ab´a)#| adj.| Que tem abas grandes: chap´eu abado.
abaetado#, (baˆe)#| adj.| Semelhante a baˆeta.
abaetar#, (baˆe) #|v. t.| Vestir com baˆeta. Fabricar (tecido que imite a baˆeta).
abafa!| interj.| Grito imperativo, para os marinheiros ferrarem as velas.
abafa¸c˜ao |f.| Acto de abafar : “Tenho ataques de abafa¸c˜ao”. Camillo, Mulher Fatal, p. 210.
abafadamente |adv.| De modo abafado.
abafadela |f.| O mesmo que abafa¸c˜ao. O mesmo que abafarete.
abafadi¸co |adj.| Suscept´ıvel de se suffocar. Que suffoca: tempo abafadi¸co. Irasc´ıvel.
abafado |adj.| Que se respira com difficuldade: ar abafado. Pouco ou mal ventilado: casa abafada. Diz-se do vinho, de cujo mosto se impediu a fermenta¸c˜ao. (De abafar ).